transactID,account,currency,transactType,amount,fee,transactStatus,address,tx,text,transactTime,walletBalance,timestamp
48bf1a48-a59c-5b6a-1946-fff7d6e89563,7696,XBt,RealisedPNL,1513,0,Completed,XBTUSD,eb4f8c69-fa71-7c81-1310-66173e57e141,,2020-08-03T12:00:00.000Z,2870636,2020-08-03T12:00:00.030Z
6bdbe880-680d-899f-c4dc-e8c7ee9826d8,7696,XBt,RealisedPNL,-69066,0,Completed,XBTUSD,e395b229-57fe-45b9-5a6e-d2e4fb5da462,,2020-07-31T12:00:00.000Z,2869123,2020-07-31T12:00:00.030Z
3ba9be6c-0a44-a599-9b2d-041220b550fa,7696,XBt,RealisedPNL,-13171,0,Completed,XBTUSD,0b9256d8-46b5-e924-fcf1-9aad89b8fce8,,2020-07-30T12:00:00.000Z,2938189,2020-07-30T12:00:00.043Z
d47be0cd-deeb-f200-628b-65f7689bf548,7696,XBt,RealisedPNL,-12424,0,Completed,XBTUSD,7f00ca99-a70e-5fc4-533e-b751f62fd5e2,,2020-07-29T12:00:00.000Z,2951360,2020-07-29T12:00:00.006Z
e17e74be-f962-d9d1-a926-708dff655079,7696,XBt,RealisedPNL,129282,0,Completed,XBTUSD,3d16d892-d4a6-54f7-5b20-4904422c765d,,2020-07-28T12:00:00.000Z,2963784,2020-07-28T12:00:00.006Z
e5db7564-be75-6c87-c5fb-f783e6abb35c,7696,XBt,RealisedPNL,18439,0,Completed,XBTUSD,0c859933-c7df-de5a-ba7c-294296131366,,2020-07-27T12:00:00.000Z,2834502,2020-07-27T12:00:00.015Z
8568c772-b107-c13c-05ea-e8bbac816db4,7696,XBt,RealisedPNL,14564,0,Completed,XBTUSD,5881e459-e784-bb99-b6d5-687060b160f1,,2020-07-26T12:00:00.000Z,2816063,2020-07-26T12:00:00.015Z
ef356c83-006f-8be2-d0be-25657c9ff8cb,7696,XBt,RealisedPNL,19861,0,Completed,XBTUSD,7c246195-9693-d4ff-e52c-378219cedfe8,,2020-07-25T12:00:00.000Z,2801499,2020-07-25T12:00:00.015Z
cfd17df6-006b-1eeb-a0a9-59da63df2223,7696,XBt,RealisedPNL,7005,0,Completed,XBTUSD,c4a5661f-f9a9-0679-5761-2c15df6351b3,,2020-07-24T12:00:00.000Z,2781638,2020-07-24T12:00:00.014Z
6ad4e009-1580-d184-e7fe-4b0f5df5afc0,7696,XBt,RealisedPNL,-9368,0,Completed,XBTUSD,ed8624d8-e2fc-a305-aef7-c879d43f3676,,2020-07-23T12:00:00.000Z,2774633,2020-07-23T12:00:00.015Z
63c11f88-f684-c37c-fd05-c4289531c53e,7696,XBt,RealisedPNL,7599,0,Completed,XBTUSD,f1fb64d1-ebd5-ba65-a260-68cf61b90acb,,2020-07-22T12:00:00.000Z,2784001,2020-07-22T12:00:00.015Z
ff661c1a-2a04-b68a-6ae5-605344ae9f80,7696,XBt,RealisedPNL,-1058,0,Completed,XBTUSD,dfd22e8d-d1ff-080b-3a51-ec5563840504,,2020-07-21T12:00:00.000Z,2776402,2020-07-21T12:00:00.015Z
50ca84f2-8d2d-6de9-a101-8296d394ff5e,7696,XBt,RealisedPNL,-4364,0,Completed,XBTUSD,250bfe1c-cbd9-13e9-7f94-2559815da7e3,,2020-07-20T12:00:00.000Z,2777460,2020-07-20T12:00:00.015Z
a42be585-c7b1-3ee7-2c04-f5039486eff1,7696,XBt,RealisedPNL,14896,0,Completed,XBTUSD,cdd86c9b-c4f4-2cfe-cb50-b857aa04d909,,2020-07-19T12:00:00.000Z,2781824,2020-07-19T12:00:00.014Z
646eaaac-640e-37fd-92f5-f52c93ad54cf,7696,XBt,RealisedPNL,18214,0,Completed,XBTUSD,e35c228e-6d34-f3d6-9349-d829563ed922,,2020-07-18T12:00:00.000Z,2766928,2020-07-18T12:00:00.015Z
c399c0ee-d086-ac69-3b2b-3a9e77c966c1,7696,XBt,RealisedPNL,8337,0,Completed,XBTUSD,93aab3a0-17b9-e2c8-0950-58dfa6ab698c,,2020-07-17T12:00:00.000Z,2748714,2020-07-17T12:00:00.015Z
17d32f25-ff5f-8bfd-aaf3-fc427dbb62c8,7696,XBt,RealisedPNL,18354,0,Completed,XBTUSD,a91f86e4-8752-b34b-e2bc-543d4ae92892,,2020-07-16T12:00:00.000Z,2740377,2020-07-16T12:00:00.015Z
d567bbf2-7ac9-14eb-a46e-203496a2bce5,7696,XBt,RealisedPNL,14340,0,Completed,XBTUSD,bf6781fc-30d5-81a5-7edb-5900ed45de91,,2020-07-15T12:00:00.000Z,2722023,2020-07-15T12:00:00.015Z
15d33cab-b1ec-477d-4997-b7b2d27dba83,7696,XBt,RealisedPNL,11909,0,Completed,XBTUSD,eb4cb89a-2873-657c-a001-b42ca16100dc,,2020-07-14T12:00:00.000Z,2707683,2020-07-14T12:00:00.014Z
399e3c5f-f220-c3e1-15a3-b37e9cbdc526,7696,XBt,RealisedPNL,18980,0,Completed,XBTUSD,bfc152ba-d0dc-06c5-3616-909886f13402,,2020-07-13T12:00:00.000Z,2695774,2020-07-13T12:00:00.014Z
08439dff-e823-368a-e9ba-57a0ac28a601,7696,XBt,RealisedPNL,18580,0,Completed,XBTUSD,2c2a982f-ec5b-f00f-554d-49a4cf81ee7a,,2020-07-12T12:00:00.000Z,2676794,2020-07-12T12:00:00.014Z
3c05125b-0212-1107-102e-59a9f2c97d89,7696,XBt,RealisedPNL,14807,0,Completed,XBTUSD,58d27842-3710-b531-f654-bc5854d52641,,2020-07-11T12:00:00.000Z,2658214,2020-07-11T12:00:00.014Z
170bb21e-4f00-0ebb-bcb5-0eaad5324209,7696,XBt,RealisedPNL,18253,0,Completed,XBTUSD,4d956ce0-42c3-67ed-a139-d7cdf13d1ae3,,2020-07-10T12:00:00.000Z,2643407,2020-07-10T12:00:00.041Z
10e6fafd-5255-6027-d054-a5b56f78e366,7696,XBt,RealisedPNL,18594,0,Completed,XBTUSD,26c2c659-cc1b-a79c-13ad-2363924fb9b1,,2020-07-09T12:00:00.000Z,2625154,2020-07-09T12:00:00.038Z
7a1bb1b4-190b-20e1-5c55-0dbcccd753f0,7696,XBt,RealisedPNL,18931,0,Completed,XBTUSD,869fc7c8-eeaa-ffcf-30aa-d930f27d568e,,2020-07-08T12:00:00.000Z,2606560,2020-07-08T12:00:00.015Z
5a0846d6-a441-eb9f-8b5d-4240774f48d5,7696,XBt,RealisedPNL,-525,0,Completed,XBTUSD,f2121bf6-ec4f-9785-f486-c34533fa5798,,2020-07-07T12:00:00.000Z,2587629,2020-07-07T12:00:00.015Z
53777e4c-e028-8261-c626-78491a4d39d9,7696,XBt,RealisedPNL,-5429,0,Completed,XBTUSD,309917b7-7e35-8893-7355-106aa134c9d3,,2020-07-06T12:00:00.000Z,2588154,2020-07-06T12:00:00.015Z
b9fe1a39-c168-9d46-46c8-9b66a5d6686d,7696,XBt,RealisedPNL,-427,0,Completed,XBTUSD,bf8531d7-ae3d-e63f-1cff-ba0eb07156ce,,2020-07-05T12:00:00.000Z,2593583,2020-07-05T12:00:00.015Z
c13a1a1c-6c49-54a9-e389-4ec31a3d825a,7696,XBt,RealisedPNL,1350,0,Completed,XBTUSD,10fbf32d-d90c-4897-c59e-73a6177f814a,,2020-07-04T12:00:00.000Z,2594010,2020-07-04T12:00:00.014Z
3708cf12-dfd9-9a38-f111-c6e127bd231a,7696,XBt,RealisedPNL,4462,0,Completed,XBTUSD,b441dec0-0cf9-f02a-cb2d-3c09d715d5a1,,2020-07-03T12:00:00.000Z,2592660,2020-07-03T12:00:00.015Z
7d30ff49-2e6e-4356-b10f-393b936b0a8b,7696,XBt,RealisedPNL,-3765,0,Completed,XBTUSD,1da14114-676e-0322-70d6-a8ae52c11736,,2020-07-02T12:00:00.000Z,2588198,2020-07-02T12:00:00.015Z
a12cd02c-fa39-377c-6286-d6fb8cdad7f0,7696,XBt,RealisedPNL,-72985,0,Completed,XBTUSD,51bd3ad7-6c63-ad46-bfcd-5ec6fea06c64,,2020-07-01T12:00:00.000Z,2591963,2020-07-01T12:00:00.014Z
ab58f24f-e6ac-110c-3a04-12b09d5d305e,7696,XBt,RealisedPNL,-5310,0,Completed,XBTUSD,0d6c568c-5e7a-341f-0d0f-7e5bac634878,,2020-06-30T12:00:00.000Z,2664948,2020-06-30T12:00:00.015Z
89d7163b-41fe-02f5-8275-26bf758acb50,7696,XBt,RealisedPNL,-9202,0,Completed,XBTUSD,027b8e6e-5423-c464-0924-c1d284c2003a,,2020-06-29T12:00:00.000Z,2670258,2020-06-29T12:00:00.015Z
c0427ed3-437b-38b2-45e9-45106ae5d6e0,7696,XBt,RealisedPNL,-17397,0,Completed,XBTUSD,983eaff0-d257-dc51-d1ee-01db6edf9691,,2020-06-28T12:00:00.000Z,2679460,2020-06-28T12:00:00.014Z
bca5e919-2f52-e1df-35b6-e6712285a095,7696,XBt,RealisedPNL,-4902,0,Completed,XBTUSD,87366a17-cc04-8fa5-ba56-dc6471f7a07b,,2020-06-27T12:00:00.000Z,2696857,2020-06-27T12:00:00.015Z
4f5d6bf6-9bdc-4575-106c-4e74976125d6,7696,XBt,RealisedPNL,-24466,0,Completed,XBTUSD,994f8702-bbe7-6a79-4ca2-e76d65bf3c48,,2020-06-26T12:00:00.000Z,2701759,2020-06-26T12:00:00.015Z
aa50bc71-8cd7-9da9-e7b9-8d21637d8372,7696,XBt,RealisedPNL,3256,0,Completed,XBTUSD,b051fd16-06b8-1803-4f3c-d0d13ba50e10,,2020-06-25T12:00:00.000Z,2726225,2020-06-25T12:00:00.015Z
891c3e4a-146d-39a4-1696-4295d508b5b4,7696,XBt,RealisedPNL,-17472,0,Completed,XBTUSD,24a2d645-32a4-c428-2828-c91f99a97030,,2020-06-24T12:00:00.000Z,2722969,2020-06-24T12:00:00.015Z
d7aaaa0e-f05e-9a14-ec79-701bd3bb8f4c,7696,XBt,RealisedPNL,96,0,Completed,XBTUSD,7df9d848-c360-6ca3-76d3-63f07373caa4,,2020-06-23T12:00:00.000Z,2740441,2020-06-23T13:00:00.000Z
c08a4e81-8dff-85f8-2b90-7d07a01576ee,7696,XBt,RealisedPNL,88,0,Completed,XBTUSD,a7e6a7e5-16de-eb7d-39aa-ef56cf040f5f,,2020-06-23T12:00:00.000Z,2740345,2020-06-23T12:00:05.000Z
30b42009-41b3-9e2d-cdfb-f49a4befcfe7,7696,XBt,RealisedPNL,460,0,Completed,XBTUSD,ee9bd15b-4d0d-f67b-e460-b16be7a28601,,2020-06-22T12:00:00.000Z,2740257,2020-06-22T13:00:00.000Z
a90299f8-352f-ce43-4b3f-ba3b67568a45,7696,XBt,RealisedPNL,21487,0,Completed,XBTUSD,c8305bf9-a025-2c9e-668f-b52c35be777f,,2020-06-22T12:00:00.000Z,2739797,2020-06-22T12:00:05.000Z
0f4444d2-167d-4786-912d-bb79ab057269,7696,XBt,RealisedPNL,4666,0,Completed,XBTUSD,0a09722e-fdd1-5873-8bcf-4be91c17d320,,2020-06-21T12:00:00.000Z,2718310,2020-06-21T12:00:00.047Z
b0f8267a-42e5-669a-edf4-bdf807979dac,7696,XBt,RealisedPNL,2804,0,Completed,XBTUSD,54be0fb5-ba9e-e733-66aa-e29f784ff9d0,,2020-06-20T12:00:00.000Z,2713644,2020-06-20T12:00:00.047Z
f139d5f5-0740-002d-1afc-adffb5f55747,7696,XBt,RealisedPNL,3837,0,Completed,XBTUSD,c6da7387-f2b2-47ca-b653-8733061e7a84,,2020-06-19T12:00:00.000Z,2710840,2020-06-19T12:00:00.048Z
a1ccfbd2-8b0a-1bbe-a485-16a0259e4374,7696,XBt,RealisedPNL,-697,0,Completed,XBTUSD,7668fb0d-8828-7723-31f7-b28371b00338,,2020-06-18T12:00:00.000Z,2707003,2020-06-18T12:00:00.018Z
f4a71740-114e-7cbe-7139-0305c1eeaf29,7696,XBt,RealisedPNL,-226,0,Completed,XBTUSD,e6585d93-78bf-273b-eabd-2086b6897e24,,2020-06-17T12:00:00.000Z,2707700,2020-06-17T12:00:00.047Z
72ff7439-9132-ee44-79b9-0746b319c1cf,7696,XBt,RealisedPNL,3721,0,Completed,XBTUSD,491521a8-6dbb-38b1-e865-cf8efa7bdf66,,2020-06-16T12:00:00.000Z,2707926,2020-06-16T12:00:00.027Z
f370f114-73f2-9b8b-f554-637e27cd5bd5,7696,XBt,RealisedPNL,-222,0,Completed,XBTUSD,10edd2b2-7d86-c69e-2c76-15e4b01a2db6,,2020-06-15T12:00:00.000Z,2704205,2020-06-15T12:00:00.031Z
4b833474-4098-6748-0f38-cce381c88357,7696,XBt,RealisedPNL,-1534,0,Completed,XBTUSD,9b0199a0-39ff-4755-4058-b744195a2a4f,,2020-06-14T12:00:00.000Z,2704427,2020-06-14T12:00:00.027Z
13cf20e8-b020-9349-e08f-3c60fa3e1d62,7696,XBt,RealisedPNL,-4278,0,Completed,XBTUSD,106530f9-9e06-737d-2261-bcb071a8e083,,2020-06-13T12:00:00.000Z,2705961,2020-06-13T12:00:00.005Z
2ac20369-ce5f-7ae3-b479-4628905a0865,7696,XBt,RealisedPNL,-2410,0,Completed,XBTUSD,04ff131a-53e1-42a6-fa61-c75f03386896,,2020-06-12T12:00:00.000Z,2710239,2020-06-12T12:00:00.027Z
ce3bb855-7234-61f0-0da0-235877a0f45d,7696,XBt,RealisedPNL,-366,0,Completed,XBTUSD,7a735e89-0983-8868-8788-45ad2db8441c,,2020-06-11T12:00:00.000Z,2712649,2020-06-11T12:00:00.027Z
771648e5-55a7-a0cd-bb8e-f6d765eae467,7696,XBt,RealisedPNL,-123,0,Completed,XBTUSD,3d7c10c5-339a-be27-0f44-189c0a89439c,,2020-06-10T12:00:00.000Z,2713015,2020-06-10T12:00:00.047Z
f5302200-6457-157a-b2b4-b0e2a03b0d3f,7696,XBt,RealisedPNL,2508,0,Completed,XBTUSD,4809073d-889b-e566-0ccd-5a267786f594,,2020-06-09T12:00:00.000Z,2713138,2020-06-09T12:00:00.027Z
6169f422-42a1-c1bc-918d-e00e9a0f5a84,7696,XBt,RealisedPNL,4425,0,Completed,XBTUSD,78867405-a8d9-07a3-6e19-f2d02842382f,,2020-06-08T12:00:00.000Z,2710630,2020-06-08T12:00:00.004Z
6fc107fe-29f0-eca0-f077-1850f65c9fb4,7696,XBt,RealisedPNL,4319,0,Completed,XBTUSD,70a63096-efa7-bbe5-6602-6bbe00d27acb,,2020-06-07T12:00:00.000Z,2706205,2020-06-07T12:00:00.004Z
a08bffec-a677-4d0f-39ee-461cac285801,7696,XBt,RealisedPNL,1002,0,Completed,XBTUSD,0ea4e2da-1250-2562-af1e-a68cae867347,,2020-06-06T12:00:00.000Z,2701886,2020-06-06T12:00:00.004Z
226a2b3a-aea8-e130-8667-19bd342cd3ba,7696,XBt,RealisedPNL,4120,0,Completed,XBTUSD,dc9c638b-7d56-4913-2560-92475141c385,,2020-06-05T12:00:00.000Z,2700884,2020-06-05T12:00:00.004Z
cdaddece-bd7e-2fde-cc78-f8058faa0e70,7696,XBt,RealisedPNL,497,0,Completed,XBTUSD,37c75655-7f68-9560-6798-409de3e6bbb5,,2020-06-04T12:00:00.000Z,2696764,2020-06-04T12:00:00.047Z
9d233cdc-5525-c151-58f2-6594c0d58bdb,7696,XBt,RealisedPNL,-2516,0,Completed,XBTUSD,d9a98c20-2a9a-34a6-c6d7-b07d37bcf1ea,,2020-06-03T12:00:00.000Z,2696267,2020-06-03T12:00:00.007Z
39d6d33e-6bc4-adcf-46de-65a1d2cf9377,7696,XBt,RealisedPNL,-75,0,Completed,XBTUSD,6f2ba11d-47fa-71bb-1dac-0f82cdfbe331,,2020-06-02T12:00:00.000Z,2698783,2020-06-02T12:00:00.043Z
a5cb5515-11fe-ba9e-3e43-52c6283d2bd1,7696,XBt,RealisedPNL,5610,0,Completed,XBTUSD,d7cbb55a-3893-8925-7c89-5ca82f07e8e2,,2020-06-01T12:00:00.000Z,2698858,2020-06-01T12:00:00.043Z
35dd6525-3cde-bb47-8117-cbb05adbb9db,7696,XBt,RealisedPNL,3390,0,Completed,XBTUSD,3f46dbc4-4d6c-b157-5bf9-a5f62eec242b,,2020-05-31T12:00:00.000Z,2693248,2020-05-31T12:00:00.043Z
2b422ad9-0aa0-e00d-4cd1-612bb45b9d62,7696,XBt,RealisedPNL,5398,0,Completed,XBTUSD,f954e0d6-2ec2-984c-b659-8e63350273e0,,2020-05-30T12:00:00.000Z,2689858,2020-05-30T12:00:00.043Z
aaa20b52-1569-7217-3dc1-0aecec2d537d,7696,XBt,RealisedPNL,9181,0,Completed,XBTUSD,db8e0200-15c6-142c-cccb-355427ae9a72,,2020-05-29T12:00:00.000Z,2684460,2020-05-29T12:00:00.043Z
50934e4f-8725-75b0-a6cc-b95c2e626b7b,7696,XBt,RealisedPNL,-8448,0,Completed,XBTUSD,5be2122c-bda7-2574-3b57-098c829235c1,,2020-05-28T12:00:00.000Z,2675279,2020-05-28T12:00:00.043Z
c5530625-6450-3db3-428e-e7e8b496dadb,7696,XBt,RealisedPNL,148,0,Completed,XBTUSD,ee838458-f583-d116-cc5e-a81dfe8bc7b6,,2020-05-27T12:00:00.000Z,2683727,2020-05-27T12:00:00.043Z
fa8e2d62-8c24-55d8-05db-3ec299d97605,7696,XBt,RealisedPNL,1371,0,Completed,XBTUSD,d03c912e-021e-6ce9-54fd-90977d2abcad,,2020-05-26T12:00:00.000Z,2683579,2020-05-26T12:00:00.028Z
6f4d3a58-8591-7a58-d4ec-cf1b3722d009,7696,XBt,RealisedPNL,849,0,Completed,XBTUSD,0f04ef76-a78c-3668-4d9f-3d61b1fcce6c,,2020-05-25T12:00:00.000Z,2682208,2020-05-25T12:00:00.099Z
a85d464d-955b-1516-4976-340af705c97b,7696,XBt,RealisedPNL,594,0,Completed,XBTUSD,63e182b2-a6a8-d983-c755-b3888266cb0b,,2020-05-24T12:00:00.000Z,2681359,2020-05-24T12:00:00.099Z
244fc5d1-b5b7-5820-4cfc-6d3a34d2f458,7696,XBt,RealisedPNL,1296,0,Completed,XBTUSD,d97be3cb-cd13-eb69-1460-6614b08396f9,,2020-05-23T12:00:00.000Z,2680765,2020-05-23T12:00:00.099Z
a07bed22-f899-5cae-740f-6f578ab6e2ae,7696,XBt,RealisedPNL,1402,0,Completed,XBTUSD,de4470b7-a74e-d768-1a51-a957ba89753f,,2020-05-22T12:00:00.000Z,2679469,2020-05-22T12:00:00.099Z
63f459b0-fe92-c2b8-7fa6-0c4b0fea25f0,7696,XBt,RealisedPNL,-1885,0,Completed,XBTUSD,cab66867-0378-821f-2485-a746369445fc,,2020-05-21T12:00:00.000Z,2678067,2020-05-21T12:00:00.099Z
157f09cb-a497-bf5d-275e-df55d63f59dd,7696,XBt,RealisedPNL,1040,0,Completed,XBTUSD,c13bd881-a4b2-f80b-a9bb-f7b1e00b0ff5,,2020-05-20T12:00:00.000Z,2679952,2020-05-20T12:00:00.033Z
f4f36724-f329-9917-f1d0-4ad2d53ca9ed,7696,XBt,RealisedPNL,1217,0,Completed,XBTUSD,d0496f6c-9bf6-fc3e-b586-87d24bdae66c,,2020-05-19T12:00:00.000Z,2678912,2020-05-19T12:00:00.034Z
53e01920-1508-0956-2d82-cc6b48fe3427,7696,XBt,RealisedPNL,572,0,Completed,XBTUSD,b7f930f1-e63f-9a37-7620-38f66d7a559c,,2020-05-18T12:00:00.000Z,2677695,2020-05-18T12:00:00.001Z
3e967169-99f1-5e06-137f-09b84b2a488f,7696,XBt,RealisedPNL,546,0,Completed,XBTUSD,6c1b4874-9155-c87d-d86a-a058008b94a0,,2020-05-17T12:00:00.000Z,2677123,2020-05-17T12:00:00.044Z
d3164ef1-5eee-c661-a437-5502b87c05fc,7696,XBt,RealisedPNL,110683,0,Completed,XBTUSD,0df2abc7-6357-db43-6ba3-7575706b4423,,2020-05-16T12:00:00.000Z,2676577,2020-05-16T12:00:00.000Z
e1dd0bfa-231d-2230-e1e9-ff6a50a4be6d,7696,XBt,RealisedPNL,54590,0,Completed,XBTUSD,a33d9090-d1df-00d4-3d28-8c45897e03be,,2020-05-15T12:00:00.000Z,2565894,2020-05-15T12:00:00.044Z
6128e581-a62c-5f48-f762-3d687383d839,7696,XBt,RealisedPNL,2300,0,Completed,XBTUSD,e08eae28-7aea-6d98-5dc9-a7eb769b7aed,,2020-05-14T12:00:00.000Z,2511304,2020-05-14T12:00:00.044Z
3ae211d2-cf96-b0ee-d2f8-af5c0b576cfa,7696,XBt,RealisedPNL,498,0,Completed,XBTUSD,50d8ef7c-87ad-9e38-995f-485f79e578b4,,2020-05-13T12:00:00.000Z,2509004,2020-05-13T12:00:00.091Z
254cfa3f-aaf4-e4f3-0906-9a6c039cbeb4,7696,XBt,RealisedPNL,248,0,Completed,XBTUSD,60090e61-ac3e-2bc0-53a0-623826dd99ac,,2020-05-12T12:00:00.000Z,2508506,2020-05-12T12:00:00.040Z
f953f75b-538c-4fbf-00a3-471b8a160a8c,7696,XBt,RealisedPNL,669,0,Completed,XBTUSD,70736995-03ed-8498-a402-6c2259ec5534,,2020-05-11T12:00:00.000Z,2508258,2020-05-11T12:00:00.040Z
89c9be70-e584-ae45-ea5c-f7b3a0299de7,7696,XBt,RealisedPNL,1733,0,Completed,XBTUSD,f896e009-190c-2d46-47c7-071e82b37568,,2020-05-10T12:00:00.000Z,2507589,2020-05-10T12:00:00.040Z
36351653-219d-6ed6-ed2e-fc0138a35209,7696,XBt,RealisedPNL,4854,0,Completed,XBTUSD,fa780995-2363-358d-2aae-cf0e5a048fd2,,2020-05-09T12:00:00.000Z,2505856,2020-05-09T12:00:00.040Z
598df9b8-64a7-9c14-12ce-549c997f146a,7696,XBt,RealisedPNL,2485,0,Completed,XBTUSD,390b3c4b-2224-f1b7-b599-492c7c90b4a1,,2020-05-08T12:00:00.000Z,2501002,2020-05-08T12:00:00.040Z
cb5595d9-8677-0c86-7015-a935d473ef5d,7696,XBt,RealisedPNL,5784,0,Completed,XBTUSD,4a4d65aa-8a76-ee07-5adc-bd80ae98fe21,,2020-05-07T12:00:00.000Z,2498517,2020-05-07T12:00:00.089Z
008ba653-5eac-a80f-8db7-181b6719ada5,7696,XBt,RealisedPNL,5080,0,Completed,XBTUSD,fb70b918-7c36-7764-c80d-c132770dd599,,2020-05-06T12:00:00.000Z,2492733,2020-05-06T12:00:00.087Z
7cc27b0f-cedd-4aa1-cad9-15d00b889883,7696,XBt,RealisedPNL,1831,0,Completed,XBTUSD,09e7f6fd-4cc9-37e0-34ef-d175892f3461,,2020-05-05T12:00:00.000Z,2487653,2020-05-05T12:00:00.085Z
18086aff-d124-2e67-89a9-f2c1ec7a76e6,7696,XBt,RealisedPNL,3987,0,Completed,XBTUSD,6510ea6c-6dcf-e87e-90a4-98caf805eedf,,2020-05-04T12:00:00.000Z,2485822,2020-05-04T12:00:00.087Z
4b14589c-c9fb-29d1-62aa-0232c74fcf18,7696,XBt,RealisedPNL,-1173,0,Completed,XBTUSD,0e791bba-dfb7-9694-ef90-81ba30d7ba62,,2020-05-03T12:00:00.000Z,2481835,2020-05-03T12:00:00.044Z
139ab545-5c9c-3f9b-112f-29444286645c,7696,XBt,RealisedPNL,-135,0,Completed,XBTUSD,743678ed-3ad0-68ee-14fd-9cce70c77804,,2020-05-02T12:00:00.000Z,2483008,2020-05-02T12:00:00.043Z
b71e9840-e9c7-7c87-3f37-4c7698b49991,7696,XBt,RealisedPNL,-136,0,Completed,XBTUSD,cf70d10f-c5e5-b363-8bca-579d8b8cecb0,,2020-05-01T12:00:00.000Z,2483143,2020-05-01T12:00:00.043Z
d9aeb262-811d-00ec-56ae-ac03fa06adc6,7696,XBt,RealisedPNL,-367,0,Completed,XBTUSD,a9a193e8-04ef-bf7e-a6f5-89ef8569b096,,2020-04-30T12:00:00.000Z,2483279,2020-04-30T12:00:00.043Z
7a0f69fb-ce77-3eaa-a0c8-4041e7924923,7696,XBt,RealisedPNL,279,0,Completed,XBTUSD,44a3eb4d-bdc2-4f4b-e7b5-5b7fac37ce96,,2020-04-29T12:00:00.000Z,2483646,2020-04-29T12:00:00.044Z
5c2937ba-d73f-a994-8cc8-5c72480598fb,7696,XBt,RealisedPNL,6414,0,Completed,XBTUSD,86313066-ae4d-9c4a-fae7-a19375ef1f47,,2020-04-28T12:00:00.000Z,2483367,2020-04-28T12:00:00.043Z
bb59c626-3248-0763-4554-bea36447ca40,7696,XBt,RealisedPNL,5025,0,Completed,XBTUSD,d1a3528d-f398-bd98-ee6a-3d4562a82e0c,,2020-04-27T12:00:00.000Z,2476953,2020-04-27T12:00:00.043Z
0fc1bd94-f0ae-387b-0680-df5decd5f935,7696,XBt,RealisedPNL,632,0,Completed,XBTUSD,13cc6042-dc18-9aa1-cd24-9b0de494bc1f,,2020-04-26T12:00:00.000Z,2471928,2020-04-26T12:00:00.001Z
dcee9183-6c08-daed-5b6b-a178c0703590,7696,XBt,RealisedPNL,-80,0,Completed,XBTUSD,f886b90c-7b41-7778-823d-fc5f9cd65062,,2020-04-25T12:00:00.000Z,2471296,2020-04-25T12:00:00.001Z
84df4bcd-6c15-7894-2477-06d9221936b7,7696,XBt,RealisedPNL,20105,0,Completed,XBTUSD,0cddcfcb-4c7e-296c-767c-c9df904b7416,,2020-04-24T12:00:00.000Z,2471376,2020-04-24T12:00:00.001Z
ba61b058-0971-d9ce-a7e3-08193bedf738,7696,XBt,RealisedPNL,926,0,Completed,XBTUSD,98a85a3b-bd79-f843-5ee7-3382cf22423d,,2020-04-23T12:00:00.000Z,2451271,2020-04-23T12:00:00.001Z
4e5e1e44-04fb-1b54-26a3-80d5d1a4f1c0,7696,XBt,RealisedPNL,43,0,Completed,XBTUSD,c85ee858-2477-5f39-482d-1e2a39f7ab46,,2020-04-22T12:00:00.000Z,2450345,2020-04-22T12:00:00.093Z
fc3060c0-575a-da1b-a412-ef7810c4bd19,7696,XBt,RealisedPNL,6844,0,Completed,XBTUSD,dd6ad328-84f9-78e8-992e-3ff058aaf97c,,2020-04-21T12:00:00.000Z,2450302,2020-04-21T12:00:00.093Z
5f10051d-db27-0a33-ef5a-799fa2cf6b95,7696,XBt,RealisedPNL,6184,0,Completed,XBTUSD,a3d39c77-beb8-e602-80e9-cfd3bd2a8951,,2020-04-20T12:00:00.000Z,2443458,2020-04-20T12:00:00.000Z
f62c32a3-b265-786b-f97f-47f0be2fbeb9,7696,XBt,RealisedPNL,6881,0,Completed,XBTUSD,1b54f3a7-94dd-df15-59cd-35c7abbe1391,,2020-04-19T12:00:00.000Z,2437274,2020-04-19T12:00:00.075Z
6de728fa-bb34-da31-00dc-879f7bce7e7a,7696,XBt,RealisedPNL,6985,0,Completed,XBTUSD,f5953953-eae9-0339-4f3e-2d41ef529e2b,,2020-04-18T12:00:00.000Z,2430393,2020-04-18T12:00:00.075Z
c9d6eaa8-8255-a11b-9e7f-5244dc2c3835,7696,XBt,RealisedPNL,631,0,Completed,XBTUSD,fa43aadc-ecd4-3489-6b24-ce02ebdde453,,2020-04-17T12:00:00.000Z,2423408,2020-04-17T12:00:00.075Z
c4dfb513-c7ac-b803-a5a5-961104119f98,7696,XBt,RealisedPNL,5334,0,Completed,XBTUSD,13abcd71-9fe9-0406-acaa-d6f7ea9d2a0a,,2020-04-16T12:00:00.000Z,2422777,2020-04-16T12:00:00.081Z
ebbcaa5d-9866-e66c-63d3-2c3f1d3d7ae6,7696,XBt,RealisedPNL,8379,0,Completed,XBTUSD,db9b7618-a2d3-3790-6e99-5b248040ad6a,,2020-04-15T12:00:00.000Z,2417443,2020-04-15T12:00:00.073Z
48854274-c070-3bf8-9be0-c74167b1a676,7696,XBt,RealisedPNL,-1222,0,Completed,XBTUSD,b33977d9-2502-0595-69d9-b96966a7f1c0,,2020-04-14T12:00:00.000Z,2409064,2020-04-14T12:00:00.049Z
30dd490a-483f-48b0-40b3-55d361954de1,7696,XBt,RealisedPNL,-1307,0,Completed,XBTUSD,5da35e8c-977e-b08f-0e06-5e3e25db9cc5,,2020-04-13T12:00:00.000Z,2410286,2020-04-13T12:00:00.081Z
1ab36de9-2124-4248-8181-bf463cc81a9d,7696,XBt,RealisedPNL,-1396,0,Completed,XBTUSD,cd79cbb5-ce43-d1c9-d4a5-45bddfdc25e3,,2020-04-12T12:00:00.000Z,2411593,2020-04-12T12:00:00.081Z
5112e42d-1b19-b618-783f-899c65ac2152,7696,XBt,RealisedPNL,1,0,Completed,XBTUSD,56d78a5a-a4ef-84ef-64f6-36b01199422d,,2020-04-11T12:00:00.000Z,2412989,2020-04-11T12:00:00.081Z
8c3a2540-e4cc-7e94-546f-ddeb86fa6861,7696,XBt,RealisedPNL,578,0,Completed,XBTUSD,3229e911-9491-ebc0-9001-7d5afc0418da,,2020-04-10T12:00:00.000Z,2412988,2020-04-10T12:00:00.081Z
d3e210c6-bfa5-2e6e-fc43-988046547f7c,7696,XBt,RealisedPNL,-92,0,Completed,XBTUSD,63965f1b-9320-06b1-3e89-e60a52e0323c,,2020-04-09T12:00:00.000Z,2412410,2020-04-09T12:00:00.081Z
62807784-2f1e-9069-f36b-c9963a36fd23,7696,XBt,RealisedPNL,436,0,Completed,XBTUSD,7c00fc67-4e38-32a8-82ec-2a5716841bbf,,2020-04-08T12:00:00.000Z,2412502,2020-04-08T12:00:00.081Z
559f1e7d-142e-06b8-030a-0a2198ffe994,7696,XBt,RealisedPNL,669,0,Completed,XBTUSD,57083e11-cd87-ec08-5a80-86726cddfe5d,,2020-04-07T12:00:00.000Z,2412066,2020-04-07T12:00:00.020Z
37f9776c-851c-478d-038c-4e1fc59ab006,7696,XBt,RealisedPNL,1153,0,Completed,XBTUSD,a8d9da18-9f37-5425-7817-799dc734afbb,,2020-04-06T12:00:00.000Z,2411397,2020-04-06T12:00:00.020Z
345ffda0-1c36-0e9c-e6aa-8e3cbc5a460e,7696,XBt,RealisedPNL,-45,0,Completed,XBTUSD,e3f13635-4ecf-33bc-cf5e-effea073306a,,2020-04-05T12:00:00.000Z,2410244,2020-04-05T12:00:00.070Z
83362128-020f-5637-994b-e928ef79c8f6,7696,XBt,RealisedPNL,25,0,Completed,XBTUSD,f9298711-6f76-8d3c-3768-b82fb7bba034,,2020-04-04T12:00:00.000Z,2410289,2020-04-04T12:00:00.062Z
e7bea7ce-c2fa-b522-0e9d-d0803f2de4e8,7696,XBt,RealisedPNL,-45,0,Completed,XBTUSD,5218d240-803f-2e07-aede-6ff6d03b9387,,2020-04-03T12:00:00.000Z,2410264,2020-04-03T12:00:00.070Z
debac8c9-9e1e-f59a-b3f8-50d058b239c8,7696,XBt,RealisedPNL,-47,0,Completed,XBTUSD,643c9d06-ec6c-cc3d-56a2-671cca5c1bb9,,2020-04-02T12:00:00.000Z,2410309,2020-04-02T12:00:00.026Z
8cec1d8b-6b71-0ce3-68f4-652ea6ef8157,7696,XBt,RealisedPNL,-47,0,Completed,XBTUSD,4d953294-ddbc-334f-119c-847f2f9fd1b9,,2020-04-01T12:00:00.000Z,2410356,2020-04-01T12:00:00.094Z
111228c2-af54-5f92-a655-7de6223fd62b,7696,XBt,RealisedPNL,342,0,Completed,XBTUSD,5a18a784-763c-de74-902f-e2199b4d9fff,,2020-03-31T12:00:00.000Z,2410403,2020-03-31T12:00:00.022Z
6919daed-eacf-2aa6-1afc-664d3a1d927c,7696,XBt,RealisedPNL,-117,0,Completed,XBTUSD,ce012b16-f017-98b2-7f1b-d9cc4358bf79,,2020-03-30T12:00:00.000Z,2410061,2020-03-30T12:00:00.003Z
32a051f6-e7ca-1225-2fbe-55df6a80c67e,7696,XBt,RealisedPNL,-1288,0,Completed,XBTUSD,aeba4005-3c25-9f9d-063e-2d191a105ffc,,2020-03-26T12:00:00.000Z,2410178,2020-03-26T12:00:00.014Z
64e91be1-4a81-07c6-3ae3-daa7a2011fe8,7696,XBt,RealisedPNL,-246,0,Completed,XBTUSD,23968621-a99e-2f61-0cf4-305f53b78241,,2020-03-10T12:00:00.000Z,2411466,2020-03-10T12:00:00.071Z
8f571c5c-3f77-488c-bc95-7d3d805367d7,7696,XBt,RealisedPNL,-22135465,0,Completed,XBTUSD,941a52d8-92ec-d8ef-ece0-9e59b9121a29,,2020-03-09T12:00:00.000Z,2411712,2020-03-09T12:00:00.074Z
90b295a3-183b-9431-8b38-fbf1abbdea8b,7696,XBt,Deposit,2412483,,Completed,,,,2020-03-09T02:24:24.586Z,24547177,2020-03-09T02:24:24.586Z
fc289925-9ebe-d1b3-a1d0-ee65aa6c0d14,7696,XBt,RealisedPNL,167368,0,Completed,XBTUSD,e2255d76-3aa7-234b-8728-20c41ec2829b,,2020-03-08T12:00:00.000Z,22134694,2020-03-08T12:00:00.000Z
4a1192c3-1cbd-129e-7fc5-b463a0a5ff7d,7696,XBt,RealisedPNL,-710907,0,Completed,XBTUSD,bf44cb4a-5bf7-d6ed-5141-f61640d31051,,2020-03-07T12:00:00.000Z,21967326,2020-03-07T12:00:00.000Z
a074c38d-6558-bfec-985d-4edac7e78aef,7696,XBt,RealisedPNL,-2450151,0,Completed,XBTUSD,8ea56831-3994-f4e7-4815-f27e367f1ab4,,2020-03-06T12:00:00.000Z,22678233,2020-03-06T12:00:00.000Z
cd9b171f-17c6-b6b9-fa5b-2f9d88500951,7696,XBt,RealisedPNL,-140756,0,Completed,XBTUSD,3540d5fa-6d92-9317-b2a1-cae8d75b2628,,2020-03-05T12:00:00.000Z,25128384,2020-03-05T12:00:00.065Z
963728d0-e58f-bc51-d4a4-88bbc5a1e398,7696,XBt,RealisedPNL,317,0,Completed,XBTUSD,853dc193-0acf-68b7-0580-010d6d98df4c,,2020-03-04T12:00:00.000Z,25269140,2020-03-04T12:00:00.009Z
ed3e0852-7fb1-1fa3-f842-fd8540eec9a0,7696,XBt,RealisedPNL,21377,0,Completed,XBTUSD,ee4d4381-0b72-e60f-d7ba-412e824ca191,,2020-03-03T12:00:00.000Z,25268823,2020-03-03T12:00:00.035Z
e2f35f64-460c-21c6-dc3c-270c1f30c35b,7696,XBt,RealisedPNL,-3155,0,Completed,XBTUSD,36c22c3d-e7a3-fefd-8797-af2f34710e8e,,2020-03-02T12:00:00.000Z,25247446,2020-03-02T12:00:00.090Z
2b2f37bf-27ac-18dd-2483-b59a8802f5c0,7696,XBt,RealisedPNL,-17513,0,Completed,XBTUSD,124198e5-5b4e-3a06-4f70-4eaf35c881ca,,2020-02-25T12:00:00.000Z,25250601,2020-02-25T12:00:00.077Z
b0d7dff0-49a0-0990-0d48-91ab163eb93f,7696,XBt,RealisedPNL,-605564,0,Completed,XBTUSD,e833965c-5ee8-c9cd-a15f-abab2228380d,,2020-02-24T12:00:00.000Z,25268114,2020-02-24T12:00:00.069Z
c9b4991a-83a5-216e-97bc-8acaa566b9f0,7696,XBt,RealisedPNL,134247,0,Completed,XBTUSD,dc1b63dd-c120-41e5-f709-8b142fb0561e,,2020-02-23T12:00:00.000Z,25873678,2020-02-23T12:00:00.052Z
c6025283-f541-fd0d-539b-d9560d4ee5b6,7696,XBt,RealisedPNL,275808,0,Completed,XBTUSD,2fe4a4c4-9d6e-9956-bcbd-ae0321d13893,,2020-02-22T12:00:00.000Z,25739431,2020-02-22T12:00:00.051Z
98fe04d1-2248-0b69-8d1c-6bbbe08d244a,7696,XBt,RealisedPNL,-232387,0,Completed,XBTUSD,82533633-eca6-d6c9-afc8-a94588be2c14,,2020-02-21T12:00:00.000Z,25463623,2020-02-21T12:00:00.051Z
6d973312-a147-008b-e791-440ddcd54dff,7696,XBt,RealisedPNL,-555314,0,Completed,XBTUSD,c9befe8b-2ec2-059a-c676-054b3577efeb,,2019-10-11T12:00:00.000Z,25696010,2019-10-11T12:00:00.026Z
3ac34465-bff9-0dd8-4e7b-7426f820747f,7696,XBt,RealisedPNL,-2411685,0,Completed,XBTUSD,74dc66c9-4dd0-4a28-9c62-f697f6b1a0ca,,2019-08-19T12:00:00.000Z,26251324,2019-08-19T12:00:00.369Z
85a3d408-46b5-3831-c9f6-f3b499466e03,7696,XBt,RealisedPNL,5054032,0,Completed,ETHUSD,bc1cd449-886d-e004-6472-86295535b66a,,2019-06-26T12:00:00.000Z,28663009,2019-06-26T12:00:00.391Z
4e3d929e-10ad-b88d-d685-ebf968865401,7696,XBt,RealisedPNL,1981,0,Completed,XBTUSD,1a78d263-96dd-7f46-dc63-66929c999a93,,2019-06-25T12:00:00.000Z,23608977,2019-06-25T12:00:00.354Z
c182d6f7-31d1-f010-39e9-3e7e44b1fcb0,7696,XBt,RealisedPNL,-12291,0,Completed,ETHUSD,1a78d263-96dd-7f46-dc63-66929c999a93,,2019-06-25T12:00:00.000Z,23606996,2019-06-25T12:00:00.354Z
491c880e-1bfa-58f7-3492-4afbf12ce03c,7696,XBt,RealisedPNL,-198465,0,Completed,ETHUSD,88f79578-0099-12af-fc13-6732c65001ff,,2019-06-24T12:00:00.000Z,23619287,2019-06-24T12:00:00.350Z
1bbdbf59-c889-ed9f-70f2-d51ad788942b,7696,XBt,RealisedPNL,-167601,0,Completed,ETHUSD,330816da-50af-b6f4-40ab-ab3926342e61,,2019-06-23T12:00:00.000Z,23817752,2019-06-23T12:00:00.304Z
6f219dca-8ff0-ed8d-de4f-80f872eb8f3c,7696,XBt,RealisedPNL,-138760,0,Completed,ETHUSD,f54f318b-d62e-caca-d63c-5e1bbd93f38b,,2019-06-22T12:00:00.000Z,23985353,2019-06-22T12:00:00.304Z
928b9fa2-3cc8-847f-1521-e0e88f4bcecb,7696,XBt,RealisedPNL,-4994,0,Completed,ETHUSD,a6fc2a4f-a76a-bb55-9443-5b868bb3af7b,,2019-06-21T12:00:00.000Z,24124113,2019-06-21T12:00:00.317Z
d4dd383a-c471-a880-2d62-bf654f1bea73,7696,XBt,RealisedPNL,16341,0,Completed,ETHUSD,f39f4b05-5471-b17b-2e8e-954e8021e350,,2019-06-20T12:00:00.000Z,24129107,2019-06-20T12:00:00.308Z
bfd179d6-51ce-8d93-ebd8-d14d1a44f5cd,7696,XBt,RealisedPNL,-1738,0,Completed,XBTUSD,827cff0b-90b0-ce60-32af-429b1e9cad04,,2019-06-19T12:00:00.000Z,24112766,2019-06-19T12:00:00.303Z
7cbcd413-aae9-c284-e4b4-c19e6d1f0cf8,7696,XBt,RealisedPNL,-116654,0,Completed,ETHUSD,827cff0b-90b0-ce60-32af-429b1e9cad04,,2019-06-19T12:00:00.000Z,24114504,2019-06-19T12:00:00.303Z
293e63b0-92d9-fc1c-b2fa-dc06613f96a0,7696,XBt,RealisedPNL,-265175444,0,Completed,XBTUSD,6d8ee221-6674-e04e-fe6a-fd6c58034330,,2019-06-18T12:00:00.000Z,24231158,2019-06-18T12:00:00.309Z
103a89f2-1eb5-388c-52dd-c88b5ec72124,7696,XBt,RealisedPNL,-189677,0,Completed,ETHUSD,6d8ee221-6674-e04e-fe6a-fd6c58034330,,2019-06-18T12:00:00.000Z,289406602,2019-06-18T12:00:00.309Z
3df57f4f-fb75-1f4f-cbc3-8f10d7d14967,7696,XBt,RealisedPNL,-3774389,0,Completed,XBTUSD,5e12df63-bc9b-537f-cb17-6121361c9c88,,2019-06-17T12:00:00.000Z,289596279,2019-06-17T12:00:00.283Z
85f252ef-5c40-555a-5c87-dd636d869a78,7696,XBt,RealisedPNL,-170053,0,Completed,ETHUSD,5e12df63-bc9b-537f-cb17-6121361c9c88,,2019-06-17T12:00:00.000Z,293370668,2019-06-17T12:00:00.283Z
d562b793-0a3b-38cf-454a-4bd1c723a77c,7696,XBt,RealisedPNL,-3846900,0,Completed,XBTUSD,09f0584b-bb86-f7b4-5d7e-cf531110fc35,,2019-06-16T12:00:00.000Z,293540721,2019-06-16T12:00:00.330Z
66057142-34bd-d9f6-bb59-7b746760b281,7696,XBt,RealisedPNL,-2497,0,Completed,ETHUSD,09f0584b-bb86-f7b4-5d7e-cf531110fc35,,2019-06-16T12:00:00.000Z,297387621,2019-06-16T12:00:00.330Z
4038629a-203e-abeb-7339-39300077525c,7696,XBt,RealisedPNL,-1435052,0,Completed,XBTUSD,e5e4c698-8844-7a4e-5ed9-382632b43d59,,2019-06-15T12:00:00.000Z,297390118,2019-06-15T12:00:00.325Z
6b6ea559-b0df-cf04-5325-799b609957d7,7696,XBt,RealisedPNL,-144977,0,Completed,ETHUSD,e5e4c698-8844-7a4e-5ed9-382632b43d59,,2019-06-15T12:00:00.000Z,298825170,2019-06-15T12:00:00.325Z
864bcc21-e46a-2ac4-fed3-4a28bbd00295,7696,XBt,RealisedPNL,-292597,0,Completed,XBTUSD,a2b061a4-72bd-6c74-2390-06ddf8d02249,,2019-06-14T12:00:00.000Z,298970147,2019-06-14T12:00:00.350Z
5cce5dee-c9e4-543c-7dad-ea84e6a30246,7696,XBt,RealisedPNL,-61438,0,Completed,ETHUSD,a2b061a4-72bd-6c74-2390-06ddf8d02249,,2019-06-14T12:00:00.000Z,299262744,2019-06-14T12:00:00.350Z
3b02f987-9bec-8329-0c53-6f03bc7cf2ef,7696,XBt,RealisedPNL,-415226,0,Completed,XBTUSD,6edabef5-605e-eacb-fef9-99cd4badc8d6,,2019-06-13T12:00:00.000Z,299324182,2019-06-13T12:00:00.329Z
0a5c3c3c-498d-03b1-1736-356cfe579795,7696,XBt,RealisedPNL,-116625,0,Completed,ETHUSD,6edabef5-605e-eacb-fef9-99cd4badc8d6,,2019-06-13T12:00:00.000Z,299739408,2019-06-13T12:00:00.329Z
856814f8-d30e-cc07-a570-9d7ea255cb42,7696,XBt,RealisedPNL,-2411106,0,Completed,XBTUSD,d147bb43-35d1-1732-49f2-a4a145e685a8,,2019-06-12T12:00:00.000Z,299856033,2019-06-12T12:00:00.272Z
78429a0b-6699-ebd0-21e6-eee6711a770d,7696,XBt,RealisedPNL,-159567,0,Completed,ETHUSD,d147bb43-35d1-1732-49f2-a4a145e685a8,,2019-06-12T12:00:00.000Z,302267139,2019-06-12T12:00:00.272Z
5fa2d0b7-98dd-6982-18fc-c1f45c94b93c,7696,XBt,RealisedPNL,-58585,0,Completed,XBTUSD,07f426da-075f-a025-36df-afe9f99e005e,,2019-06-11T12:00:00.000Z,302426706,2019-06-11T12:00:00.383Z
d5246342-82ec-3303-bd7e-5e25058a5c35,7696,XBt,RealisedPNL,-170150,0,Completed,ETHUSD,07f426da-075f-a025-36df-afe9f99e005e,,2019-06-11T12:00:00.000Z,302485291,2019-06-11T12:00:00.383Z
0e4101b3-0e3d-d54d-3efa-5721243897c8,7696,XBt,RealisedPNL,746407,0,Completed,XBTUSD,17150406-7727-06d1-fbe4-da1e463b53bd,,2019-06-10T12:00:00.000Z,302655441,2019-06-10T12:00:00.294Z
3a268e5d-000c-8d69-80ca-9bcf4b4b1d92,7696,XBt,RealisedPNL,-162132,0,Completed,ETHUSD,17150406-7727-06d1-fbe4-da1e463b53bd,,2019-06-10T12:00:00.000Z,301909034,2019-06-10T12:00:00.294Z
012ed955-abb7-c28a-1234-ff391264dd87,7696,XBt,RealisedPNL,-2744338,0,Completed,XBTUSD,98fa39eb-d6f7-95ed-b33b-cdc602de1a60,,2019-06-09T12:00:00.000Z,302071166,2019-06-09T12:00:00.287Z
0cc19ac5-62e0-f4d0-a51f-8b63313fe279,7696,XBt,RealisedPNL,-101736,0,Completed,ETHUSD,98fa39eb-d6f7-95ed-b33b-cdc602de1a60,,2019-06-09T12:00:00.000Z,304815504,2019-06-09T12:00:00.287Z
6e2d6f68-c08a-a795-7ae8-688c3b28136b,7696,XBt,RealisedPNL,-3926519,0,Completed,XBTUSD,bd7e7661-d38d-cec6-bf26-78a1a47c5d2a,,2019-06-08T12:00:00.000Z,304917240,2019-06-08T12:00:00.306Z
87409cfb-e724-1458-e9c3-23eef2f80a8e,7696,XBt,RealisedPNL,-112435,0,Completed,ETHUSD,bd7e7661-d38d-cec6-bf26-78a1a47c5d2a,,2019-06-08T12:00:00.000Z,308843759,2019-06-08T12:00:00.306Z
a1798838-2b30-e410-d8f0-684dba602f49,7696,XBt,RealisedPNL,2368787,0,Completed,XBTUSD,c66b4edb-f9d8-cf0c-6901-9d2c68629fa3,,2019-06-07T12:00:00.000Z,308956194,2019-06-07T12:00:00.315Z
deb4f5e5-db5e-5b4d-1db8-0b6c1d9126ac,7696,XBt,RealisedPNL,-170220,0,Completed,ETHUSD,c66b4edb-f9d8-cf0c-6901-9d2c68629fa3,,2019-06-07T12:00:00.000Z,306587407,2019-06-07T12:00:00.315Z
b563e8bd-07ca-f0d1-9227-90861d817da7,7696,XBt,RealisedPNL,3711008,0,Completed,XBTUSD,ddf1e4dd-7c2d-7f4f-2e61-4288defeea2f,,2019-06-06T12:00:00.000Z,306757627,2019-06-06T12:00:00.283Z
0fb896d6-d9c4-2b71-5d0c-af1321819ec2,7696,XBt,RealisedPNL,-171450,0,Completed,ETHUSD,ddf1e4dd-7c2d-7f4f-2e61-4288defeea2f,,2019-06-06T12:00:00.000Z,303046619,2019-06-06T12:00:00.283Z
040eaa91-1db6-6e9a-e9da-4989d4500eb6,7696,XBt,RealisedPNL,492080,0,Completed,XBTUSD,b6eb1b9e-3671-3055-9d65-e04928ceee7c,,2019-06-05T12:00:00.000Z,303218069,2019-06-05T12:00:00.308Z
8d505f21-f8ef-459d-9fe3-206498ddd769,7696,XBt,RealisedPNL,-168121,0,Completed,ETHUSD,b6eb1b9e-3671-3055-9d65-e04928ceee7c,,2019-06-05T12:00:00.000Z,302725989,2019-06-05T12:00:00.308Z
a0b3a65e-db1f-6c3a-c607-b0eba09a24cc,7696,XBt,RealisedPNL,-1962097,0,Completed,XBTUSD,6aea3a48-7377-41a0-5206-67736f86a59f,,2019-06-04T12:00:00.000Z,302894110,2019-06-04T12:00:00.311Z
c2414d5c-bfd8-c444-bf07-75a838e1c70e,7696,XBt,RealisedPNL,-178262,0,Completed,ETHUSD,6aea3a48-7377-41a0-5206-67736f86a59f,,2019-06-04T12:00:00.000Z,304856207,2019-06-04T12:00:00.311Z
998c1ef2-a4cc-875f-ddf1-f3a6443b8e5f,7696,XBt,RealisedPNL,-1376176,0,Completed,XBTUSD,cdeb8bcc-f0c9-b783-c3fb-71696636a619,,2019-06-03T12:00:00.000Z,305034469,2019-06-03T12:00:00.297Z
f9c2b0b1-fb2a-caf5-fd45-15d4de184357,7696,XBt,RealisedPNL,-186665,0,Completed,ETHUSD,cdeb8bcc-f0c9-b783-c3fb-71696636a619,,2019-06-03T12:00:00.000Z,306410645,2019-06-03T12:00:00.297Z
93db1a99-58fc-3691-ce27-8345af09a584,7696,XBt,RealisedPNL,-75758,0,Completed,XBTUSD,6a836d5a-f725-6789-488b-417eed402ba6,,2019-06-02T12:00:00.000Z,306597310,2019-06-02T12:00:00.239Z
10558bf3-ed05-da64-6dbf-cc86b0a19042,7696,XBt,RealisedPNL,-142097,0,Completed,ETHUSD,6a836d5a-f725-6789-488b-417eed402ba6,,2019-06-02T12:00:00.000Z,306673068,2019-06-02T12:00:00.239Z
9c29baec-cbb2-2635-dd6c-20b22ba41b2d,7696,XBt,RealisedPNL,3879188,0,Completed,XBTUSD,8ad9644b-a7bd-bf9d-ef29-de4dc7a80a29,,2019-06-01T12:00:00.000Z,306815165,2019-06-01T12:00:00.254Z
99efed3d-beb6-3621-2e51-1522912459dd,7696,XBt,RealisedPNL,-166812,0,Completed,ETHUSD,8ad9644b-a7bd-bf9d-ef29-de4dc7a80a29,,2019-06-01T12:00:00.000Z,302935977,2019-06-01T12:00:00.254Z
80b84059-61d6-12ba-fcb6-baa3a1514030,7696,XBt,RealisedPNL,2721148,0,Completed,XBTUSD,6980d7ef-3dfc-dc53-54a4-87ac8797ade2,,2019-05-31T12:00:00.000Z,303102789,2019-05-31T12:00:00.241Z
d086ac76-892a-c6ce-d7e5-2772dea8a336,7696,XBt,RealisedPNL,-76622,0,Completed,ETHUSD,6980d7ef-3dfc-dc53-54a4-87ac8797ade2,,2019-05-31T12:00:00.000Z,300381641,2019-05-31T12:00:00.241Z
edb0b3ef-2e3b-d015-f842-8779c1cdadd4,7696,XBt,RealisedPNL,2187989,0,Completed,XBTUSD,0a6c65b8-02c5-2683-4c3a-9a92dc35250b,,2019-05-30T12:00:00.000Z,300458263,2019-05-30T12:00:00.229Z
c2faa0f3-22a8-7613-7f1b-d4e4de7fee25,7696,XBt,RealisedPNL,113796,0,Completed,ETHUSD,0a6c65b8-02c5-2683-4c3a-9a92dc35250b,,2019-05-30T12:00:00.000Z,298270274,2019-05-30T12:00:00.229Z
cb8eb2fc-7827-91c7-b84c-04f9575437d3,7696,XBt,RealisedPNL,-349551,0,Completed,XBTUSD,84054eac-c9f1-ffdd-5386-c9de58eeabed,,2019-05-29T12:00:00.000Z,298156478,2019-05-29T12:00:00.241Z
5fe31845-ec48-3158-3390-13e3f7158a04,7696,XBt,RealisedPNL,-2280,0,Completed,ETHUSD,84054eac-c9f1-ffdd-5386-c9de58eeabed,,2019-05-29T12:00:00.000Z,298506029,2019-05-29T12:00:00.241Z
57a72b13-4821-a429-7644-145f04b2b156,7696,XBt,RealisedPNL,-2558380,0,Completed,XBTUSD,294c496a-a322-e5ce-db79-e1e7f3fffe1f,,2019-05-28T12:00:00.000Z,298508309,2019-05-28T12:00:00.250Z
457b93bf-d593-406e-6b92-51a40a2c6a33,7696,XBt,RealisedPNL,107907,0,Completed,ETHUSD,294c496a-a322-e5ce-db79-e1e7f3fffe1f,,2019-05-28T12:00:00.000Z,301066689,2019-05-28T12:00:00.250Z
1166edba-87ab-7d41-38a0-b7959c90007d,7696,XBt,RealisedPNL,685489,0,Completed,XBTUSD,cbb15444-b123-e578-25be-788c5d936a61,,2019-05-27T12:00:00.000Z,300958782,2019-05-27T12:00:00.237Z
bbbb59d1-97e7-f330-bfdc-c3394b75987c,7696,XBt,RealisedPNL,-30166,0,Completed,ETHUSD,cbb15444-b123-e578-25be-788c5d936a61,,2019-05-27T12:00:00.000Z,300273293,2019-05-27T12:00:00.237Z
93af461c-9a2f-3c59-592c-8f69e33efded,7696,XBt,RealisedPNL,-45309,0,Completed,XBTUSD,7ec6cd4a-029f-cb52-2473-754fecfeb195,,2019-05-26T12:00:00.000Z,300303459,2019-05-26T12:00:00.258Z
4e4d9ee2-52a3-bf1b-db8a-2d514b731cab,7696,XBt,RealisedPNL,49322,0,Completed,ETHUSD,7ec6cd4a-029f-cb52-2473-754fecfeb195,,2019-05-26T12:00:00.000Z,300348768,2019-05-26T12:00:00.258Z
f371df07-5b39-6e1e-bced-8f5f80c2d1b2,7696,XBt,RealisedPNL,-842205,0,Completed,XBTUSD,9a8f656c-4a35-d455-910a-19b1f301abe3,,2019-05-25T12:00:00.000Z,300299446,2019-05-25T12:00:00.283Z
e9f9ce9c-eae5-c6b2-c319-aa0b169e93cd,7696,XBt,RealisedPNL,45827,0,Completed,ETHUSD,9a8f656c-4a35-d455-910a-19b1f301abe3,,2019-05-25T12:00:00.000Z,301141651,2019-05-25T12:00:00.283Z
305aee85-dc88-6205-8505-bfa0273d6061,7696,XBt,RealisedPNL,2653987,0,Completed,XBTUSD,bbf42b15-5bc8-9743-a7c1-e0b437650056,,2019-05-24T12:00:00.000Z,301095824,2019-05-24T12:00:00.248Z
e83362e3-bcdb-6ae1-0121-be94aad21661,7696,XBt,RealisedPNL,-56191,0,Completed,ETHUSD,bbf42b15-5bc8-9743-a7c1-e0b437650056,,2019-05-24T12:00:00.000Z,298441837,2019-05-24T12:00:00.248Z
eac0c02c-c562-dcd9-8cf0-7a34e08eefa0,7696,XBt,RealisedPNL,1309098,0,Completed,XBTUSD,f70e1648-aa5e-d10d-3c15-6363c024667b,,2019-05-23T12:00:00.000Z,298498028,2019-05-23T12:00:00.253Z
b0936943-8853-b0df-1073-36e5f16b54e1,7696,XBt,RealisedPNL,174368,0,Completed,ETHUSD,f70e1648-aa5e-d10d-3c15-6363c024667b,,2019-05-23T12:00:00.000Z,297188930,2019-05-23T12:00:00.253Z
09086e89-ac2b-a046-f5af-26458e066de4,7696,XBt,RealisedPNL,-911894,0,Completed,XBTUSD,4fdb4dc7-e357-8b49-2cc5-70cae3bd6c31,,2019-05-22T12:00:00.000Z,297014562,2019-05-22T12:00:00.280Z
5edc3de8-21b7-1ebd-d67c-4ff42cb9150f,7696,XBt,RealisedPNL,177586,0,Completed,ETHUSD,4fdb4dc7-e357-8b49-2cc5-70cae3bd6c31,,2019-05-22T12:00:00.000Z,297926456,2019-05-22T12:00:00.280Z
ecb5c5cb-1684-0976-d77c-a3ec77f17001,7696,XBt,RealisedPNL,-3996533,0,Completed,XBTUSD,3379f080-fb06-d666-baf1-82d60a685455,,2019-05-21T12:00:00.000Z,297748870,2019-05-21T12:00:00.246Z
aed26fbe-0178-ac90-2d00-f881067d5420,7696,XBt,RealisedPNL,173840,0,Completed,ETHUSD,3379f080-fb06-d666-baf1-82d60a685455,,2019-05-21T12:00:00.000Z,301745403,2019-05-21T12:00:00.246Z
7b162310-a5ce-1ac3-bcb7-c4ae810b725c,7696,XBt,RealisedPNL,-2643326,0,Completed,XBTUSD,f5c89f89-2fdc-6eec-e1df-bf26c9b8b6d9,,2019-05-20T12:00:00.000Z,301571563,2019-05-20T12:00:00.273Z
104b4824-e014-85d3-9eda-04a61b8bf5ce,7696,XBt,RealisedPNL,-102603,0,Completed,ETHUSD,f5c89f89-2fdc-6eec-e1df-bf26c9b8b6d9,,2019-05-20T12:00:00.000Z,304214889,2019-05-20T12:00:00.273Z
4865a0a3-c57c-259e-61f7-7a0994f640dc,7696,XBt,RealisedPNL,4078060,0,Completed,XBTUSD,5561b429-d5de-7de2-4bfb-cb4ca346062f,,2019-05-19T12:00:00.000Z,304317492,2019-05-19T12:00:00.268Z
342da473-a771-aabf-9a3a-f57d578b9be5,7696,XBt,RealisedPNL,21871,0,Completed,ETHUSD,5561b429-d5de-7de2-4bfb-cb4ca346062f,,2019-05-19T12:00:00.000Z,300239432,2019-05-19T12:00:00.268Z
dc208e7a-9c88-e530-c661-0f2365d7bcec,7696,XBt,RealisedPNL,4033468,0,Completed,XBTUSD,c22ae094-8991-352f-8efc-b88058e81966,,2019-05-18T12:00:00.000Z,300217561,2019-05-18T12:00:00.334Z
b45e675c-2bfe-8e01-7249-5eb76f656e16,7696,XBt,RealisedPNL,109387,0,Completed,ETHUSD,c22ae094-8991-352f-8efc-b88058e81966,,2019-05-18T12:00:00.000Z,296184093,2019-05-18T12:00:00.334Z
894ddfff-12e9-4ecc-ebd6-543c73abb471,7696,XBt,RealisedPNL,2876641,0,Completed,XBTUSD,7c1e46b6-3b87-7f5a-cf6c-e9f4d4bf9db6,,2019-05-17T12:00:00.000Z,296074706,2019-05-17T12:00:00.262Z
1713707c-204e-1085-3e2f-c2d9d5cca1bb,7696,XBt,RealisedPNL,174142,0,Completed,ETHUSD,7c1e46b6-3b87-7f5a-cf6c-e9f4d4bf9db6,,2019-05-17T12:00:00.000Z,293198065,2019-05-17T12:00:00.262Z
d9682b1b-5f37-d09d-7c64-a3c9f55de0bc,7696,XBt,RealisedPNL,44028,0,Completed,XBTUSD,2e4904cb-a177-64d9-697c-89dcabb7d2fe,,2019-05-16T12:00:00.000Z,293023923,2019-05-16T12:00:00.315Z
9ae579f9-4602-0db4-f018-0fb6a06bb881,7696,XBt,RealisedPNL,161803,0,Completed,ETHUSD,2e4904cb-a177-64d9-697c-89dcabb7d2fe,,2019-05-16T12:00:00.000Z,292979895,2019-05-16T12:00:00.315Z
9a7f697a-0b22-674c-7cc8-4c8b1998450d,7696,XBt,RealisedPNL,-1288750,0,Completed,XBTUSD,9b682228-0b45-dcf4-2bb2-df4466829739,,2019-05-15T12:00:00.000Z,292818092,2019-05-15T12:00:00.237Z
aeae5203-4e41-cb0b-5aec-23080f8a020d,7696,XBt,RealisedPNL,146951,0,Completed,ETHUSD,9b682228-0b45-dcf4-2bb2-df4466829739,,2019-05-15T12:00:00.000Z,294106842,2019-05-15T12:00:00.237Z
b7a1eaa4-feba-9387-ca0f-52a87c5e1c76,7696,XBt,RealisedPNL,3003292,0,Completed,XBTUSD,41cd621b-78f2-3eb2-dfcd-e00a48926cda,,2019-05-14T12:00:00.000Z,293959891,2019-05-14T12:00:00.272Z
f0d7e726-4658-f533-2ff5-6f35ee90d677,7696,XBt,RealisedPNL,-93648,0,Completed,ETHUSD,41cd621b-78f2-3eb2-dfcd-e00a48926cda,,2019-05-14T12:00:00.000Z,290956599,2019-05-14T12:00:00.272Z
c9d8c19f-18de-1c53-0a33-9a3020ec0cbe,7696,XBt,RealisedPNL,2011422,0,Completed,XBTUSD,28a8eb45-56ae-3314-0f2d-5c20925e2111,,2019-05-13T12:00:00.000Z,291050247,2019-05-13T12:00:00.237Z
1236d03b-8ee3-df90-39ff-34fd4f960c6c,7696,XBt,RealisedPNL,87827,0,Completed,ETHUSD,28a8eb45-56ae-3314-0f2d-5c20925e2111,,2019-05-13T12:00:00.000Z,289038825,2019-05-13T12:00:00.237Z
1c252fe8-004d-4810-311a-82b076aa818e,7696,XBt,RealisedPNL,-3579813,0,Completed,XBTUSD,39c07fa7-61b0-db3f-1bd9-4fbfe16a6c0b,,2019-05-12T12:00:00.000Z,288950998,2019-05-12T12:00:00.284Z
f5ce5169-7ac2-b726-f75a-780c9a2c0fb3,7696,XBt,RealisedPNL,-77637,0,Completed,ETHUSD,39c07fa7-61b0-db3f-1bd9-4fbfe16a6c0b,,2019-05-12T12:00:00.000Z,292530811,2019-05-12T12:00:00.284Z
71b8c7d0-fe9a-9a9d-0816-efb9123dee0b,7696,XBt,RealisedPNL,-2204169,0,Completed,XBTUSD,b89c4ba1-2e8a-9591-6bed-19e1639960b5,,2019-05-11T12:00:00.000Z,292608448,2019-05-11T12:00:00.231Z
c4a81df6-836a-8a64-4a49-6f6761403e15,7696,XBt,RealisedPNL,-48748,0,Completed,ETHUSD,b89c4ba1-2e8a-9591-6bed-19e1639960b5,,2019-05-11T12:00:00.000Z,294812617,2019-05-11T12:00:00.231Z
bdf842aa-3bac-8116-c138-f42a9eb1c6ea,7696,XBt,RealisedPNL,-5413774,0,Completed,XBTUSD,68effd0b-8a71-fda6-e178-88d47f6bfa09,,2019-05-10T12:00:00.000Z,294861365,2019-05-10T12:00:00.192Z
5b714048-da82-74ae-429f-55f690f4453b,7696,XBt,RealisedPNL,-8741,0,Completed,ETHUSD,68effd0b-8a71-fda6-e178-88d47f6bfa09,,2019-05-10T12:00:00.000Z,300275139,2019-05-10T12:00:00.192Z
312e2428-2ff4-313b-5f35-beedc1ea5184,7696,XBt,RealisedPNL,-456498,0,Completed,XBTUSD,57ed8163-b635-a066-10ce-c14fc0d30d80,,2019-05-09T12:00:00.000Z,300283880,2019-05-09T12:00:00.262Z
0170974e-1159-576c-139a-048c6670c1ea,7696,XBt,RealisedPNL,-26755,0,Completed,ETHUSD,57ed8163-b635-a066-10ce-c14fc0d30d80,,2019-05-09T12:00:00.000Z,300740378,2019-05-09T12:00:00.262Z
182179df-8113-41c0-6767-b8e88b7feb5f,7696,XBt,RealisedPNL,-2306084,0,Completed,XBTUSD,e4542b42-c4f2-8174-908c-3c7ead8f54c8,,2019-05-08T12:00:00.000Z,300767133,2019-05-08T12:00:00.248Z
4d3ac43d-784d-3dae-8315-dce937a0850d,7696,XBt,RealisedPNL,2230,0,Completed,ETHUSD,e4542b42-c4f2-8174-908c-3c7ead8f54c8,,2019-05-08T12:00:00.000Z,303073217,2019-05-08T12:00:00.248Z
d309c078-caf4-8898-d2bd-e553db00f88e,7696,XBt,RealisedPNL,3782813,0,Completed,XBTUSD,05abdbe1-2dfd-110b-089b-619909e8077f,,2019-05-07T12:00:00.000Z,303070987,2019-05-07T12:00:00.269Z
223e5d31-85e8-b2af-a018-da4bddb1861f,7696,XBt,RealisedPNL,188601,0,Completed,ETHUSD,05abdbe1-2dfd-110b-089b-619909e8077f,,2019-05-07T12:00:00.000Z,299288174,2019-05-07T12:00:00.269Z
e39c5e55-cf38-7a3c-c785-329eca479f24,7696,XBt,RealisedPNL,3694193,0,Completed,XBTUSD,31e9983a-6f65-80bf-bc4c-8dac9c7edb81,,2019-05-06T12:00:00.000Z,299099573,2019-05-06T12:00:00.280Z
de2adf8d-e23a-10dd-663e-97fb0c74a29d,7696,XBt,RealisedPNL,97415,0,Completed,ETHUSD,31e9983a-6f65-80bf-bc4c-8dac9c7edb81,,2019-05-06T12:00:00.000Z,295405380,2019-05-06T12:00:00.280Z
89a60bfe-14b9-6088-fd7b-ae7ee51f4c22,7696,XBt,RealisedPNL,5707544,0,Completed,XBTUSD,236719d4-f7d1-b945-8343-86209b244bde,,2019-05-05T12:00:00.000Z,295307965,2019-05-05T12:00:00.251Z
ab0c90cd-13e8-f4d1-6abb-09d1ddcc2043,7696,XBt,RealisedPNL,30315,0,Completed,ETHUSD,236719d4-f7d1-b945-8343-86209b244bde,,2019-05-05T12:00:00.000Z,289600421,2019-05-05T12:00:00.251Z
8504cfe0-02cd-35bb-dd9d-8d175efb7062,7696,XBt,RealisedPNL,3027810,0,Completed,XBTUSD,288713c8-6f6a-0c23-cfc1-c990eb473686,,2019-05-04T12:00:00.000Z,289570106,2019-05-04T12:00:00.336Z
4a4e20fd-aaef-4a21-a076-24d6d3138b27,7696,XBt,RealisedPNL,52667,0,Completed,ETHUSD,288713c8-6f6a-0c23-cfc1-c990eb473686,,2019-05-04T12:00:00.000Z,286542296,2019-05-04T12:00:00.336Z
4f40d117-1ef7-026b-097f-4111af6c06e0,7696,XBt,RealisedPNL,404070,0,Completed,XBTUSD,388aef73-1a86-981d-162a-bee4b54f9fc2,,2019-05-03T12:00:00.000Z,286489629,2019-05-03T12:00:00.268Z
3edbec18-9eae-577b-9701-be9426f98127,7696,XBt,RealisedPNL,-56953,0,Completed,ETHUSD,388aef73-1a86-981d-162a-bee4b54f9fc2,,2019-05-03T12:00:00.000Z,286085559,2019-05-03T12:00:00.268Z
d46756bd-3691-2c63-6441-dad722ef5b60,7696,XBt,RealisedPNL,3069943,0,Completed,XBTUSD,5f4beec5-39a7-fa87-83ec-31d5dde8cd4d,,2019-05-02T12:00:00.000Z,286142512,2019-05-02T12:00:00.289Z
5a954c23-a96a-369a-d5b3-0fb4db8d24a1,7696,XBt,RealisedPNL,-141662,0,Completed,ETHUSD,5f4beec5-39a7-fa87-83ec-31d5dde8cd4d,,2019-05-02T12:00:00.000Z,283072569,2019-05-02T12:00:00.289Z
44d7ac73-daeb-e54a-3f8b-2dc977feb4fd,7696,XBt,RealisedPNL,738739,0,Completed,XBTUSD,d386e393-b3de-609d-f7ae-ccdf5a7472e3,,2019-05-01T12:00:00.000Z,283214231,2019-05-01T12:00:00.253Z
8ce76199-efa9-72c4-48b4-47092c35f02c,7696,XBt,RealisedPNL,15174,0,Completed,ETHUSD,d386e393-b3de-609d-f7ae-ccdf5a7472e3,,2019-05-01T12:00:00.000Z,282475492,2019-05-01T12:00:00.253Z
a8deb221-e5a7-5800-b752-1ab74d11dbb9,7696,XBt,RealisedPNL,1712210,0,Completed,XBTUSD,315eaef8-5edf-4335-3e9b-c314b9b40752,,2019-04-30T12:00:00.000Z,282460318,2019-04-30T12:00:00.181Z
f276016d-7a72-20a3-cb42-9d25e1806a19,7696,XBt,RealisedPNL,-72252,0,Completed,ETHUSD,315eaef8-5edf-4335-3e9b-c314b9b40752,,2019-04-30T12:00:00.000Z,280748108,2019-04-30T12:00:00.181Z
68c6b978-6ba9-ecf3-ee69-e50fe85c86de,7696,XBt,RealisedPNL,1261194,0,Completed,XBTUSD,19f7e96f-fe0f-611a-3eb7-eaa0c43bdbae,,2019-04-29T12:00:00.000Z,280820360,2019-04-29T12:00:00.249Z
2baaab0b-8016-9e72-bd36-63e93ecf42aa,7696,XBt,RealisedPNL,-54244,0,Completed,ETHUSD,19f7e96f-fe0f-611a-3eb7-eaa0c43bdbae,,2019-04-29T12:00:00.000Z,279559166,2019-04-29T12:00:00.249Z
76dbe876-12e9-19bd-e6fd-54e2e37b1f7f,7696,XBt,RealisedPNL,1877625,0,Completed,XBTUSD,b3835ec2-f158-4ffa-7cd5-0b882db7b689,,2019-04-28T12:00:00.000Z,279613410,2019-04-28T12:00:00.270Z
e0cbb0f3-8a1a-a44f-1f3f-bb73fa3aa0d4,7696,XBt,RealisedPNL,131567,0,Completed,ETHUSD,b3835ec2-f158-4ffa-7cd5-0b882db7b689,,2019-04-28T12:00:00.000Z,277735785,2019-04-28T12:00:00.270Z
f85109c4-33af-407a-73c8-d5920e46534e,7696,XBt,RealisedPNL,6338827,0,Completed,XBTUSD,3bfd8047-e06b-9fb1-8d3b-8c72b1479e1f,,2019-04-27T12:00:00.000Z,277604218,2019-04-27T12:00:00.246Z
5fd0b599-8b56-e5ea-ab46-a17e35ef8a04,7696,XBt,RealisedPNL,105282,0,Completed,ETHUSD,3bfd8047-e06b-9fb1-8d3b-8c72b1479e1f,,2019-04-27T12:00:00.000Z,271265391,2019-04-27T12:00:00.246Z
4e462cc7-cb90-96b2-bfd4-e00f74dd9ee7,7696,XBt,RealisedPNL,6038408,0,Completed,XBTUSD,34f8dac6-710c-716f-7c0d-85b52b226a82,,2019-04-26T12:00:00.000Z,271160109,2019-04-26T12:00:00.213Z
4e96d085-3390-0dff-382b-d0371bf93074,7696,XBt,RealisedPNL,-152462,0,Completed,ETHUSD,34f8dac6-710c-716f-7c0d-85b52b226a82,,2019-04-26T12:00:00.000Z,265121701,2019-04-26T12:00:00.213Z
99be257c-c293-7944-f96c-a96b654cf15e,7696,XBt,RealisedPNL,4703005,0,Completed,XBTUSD,638fddbf-d202-1670-0275-41c5661de3b6,,2019-04-25T12:00:00.000Z,265274163,2019-04-25T12:00:00.206Z
1352343f-a0e9-224f-8ad8-99b84aa764f3,7696,XBt,RealisedPNL,6986,0,Completed,ETHUSD,638fddbf-d202-1670-0275-41c5661de3b6,,2019-04-25T12:00:00.000Z,260571158,2019-04-25T12:00:00.206Z
34d0ab61-925e-c99e-cfb2-8967a994c3e0,7696,XBt,RealisedPNL,-4945739,0,Completed,XBTUSD,526c3f32-7572-193c-50e0-99d26f18a792,,2019-04-24T12:00:00.000Z,260564172,2019-04-24T12:00:00.198Z
22279e60-31b8-71c0-0f00-d9b447518fa9,7696,XBt,RealisedPNL,140053,0,Completed,ETHUSD,526c3f32-7572-193c-50e0-99d26f18a792,,2019-04-24T12:00:00.000Z,265509911,2019-04-24T12:00:00.198Z
def6382f-74e8-72fc-0da0-64c5e8d16bc4,7696,XBt,RealisedPNL,-2036750,0,Completed,XBTUSD,d885a3e6-ab24-ad58-335c-0f3102cc2dc1,,2019-04-23T12:00:00.000Z,265369858,2019-04-23T12:00:00.197Z
8b0aa853-ef5f-6527-9557-9e27e9360736,7696,XBt,RealisedPNL,12751,0,Completed,ETHUSD,d885a3e6-ab24-ad58-335c-0f3102cc2dc1,,2019-04-23T12:00:00.000Z,267406608,2019-04-23T12:00:00.197Z
c21f3350-34f9-d814-f820-d639f2618824,7696,XBt,RealisedPNL,-42883,0,Completed,XBTUSD,065efca9-c21b-0b83-73d2-664f8f3dc23a,,2019-04-22T12:00:00.000Z,267393857,2019-04-22T12:00:00.249Z
72683b54-6300-633c-a04d-1fa41b02c7e2,7696,XBt,RealisedPNL,176136,0,Completed,ETHUSD,065efca9-c21b-0b83-73d2-664f8f3dc23a,,2019-04-22T12:00:00.000Z,267436740,2019-04-22T12:00:00.249Z
9551d684-db44-6815-d87c-97926926021c,7696,XBt,RealisedPNL,-7719,0,Completed,XBTUSD,86aed0b8-c451-c022-2f55-01a9258f03f5,,2019-04-21T12:00:00.000Z,267260604,2019-04-21T12:00:00.246Z
e8f45072-1707-3155-74c4-95c1321e2b66,7696,XBt,RealisedPNL,175409,0,Completed,ETHUSD,86aed0b8-c451-c022-2f55-01a9258f03f5,,2019-04-21T12:00:00.000Z,267268323,2019-04-21T12:00:00.246Z
c31e9ca7-4024-f3b7-73dc-3781e45f5357,7696,XBt,RealisedPNL,106232,0,Completed,XBTUSD,dfe8d50e-63ec-ed54-e530-932d7d263391,,2019-04-20T12:00:00.000Z,267092914,2019-04-20T12:00:00.274Z
f24cd253-364e-c3a5-024a-43dc1bc2fc64,7696,XBt,RealisedPNL,51710,0,Completed,ETHUSD,dfe8d50e-63ec-ed54-e530-932d7d263391,,2019-04-20T12:00:00.000Z,266986682,2019-04-20T12:00:00.274Z
8f8cd135-2611-d4c9-7be6-4f2625ad4198,7696,XBt,RealisedPNL,-255199,0,Completed,XBTUSD,215663ef-e8f8-f83c-2750-c2088dfaf7d9,,2019-04-19T12:00:00.000Z,266934972,2019-04-19T12:00:00.270Z
e03054aa-e492-ba7c-ac4c-5f2818265345,7696,XBt,RealisedPNL,156608,0,Completed,ETHUSD,215663ef-e8f8-f83c-2750-c2088dfaf7d9,,2019-04-19T12:00:00.000Z,267190171,2019-04-19T12:00:00.270Z
289742ec-3c4a-4993-44c4-37fea301a487,7696,XBt,RealisedPNL,-3753223,0,Completed,XBTUSD,ef7a4d72-ebc9-00a9-337d-7a9165495faa,,2019-04-18T12:00:00.000Z,267033563,2019-04-18T12:00:00.248Z
66766305-edfe-d129-9498-c3b9446c91f8,7696,XBt,RealisedPNL,193683,0,Completed,ETHUSD,ef7a4d72-ebc9-00a9-337d-7a9165495faa,,2019-04-18T12:00:00.000Z,270786786,2019-04-18T12:00:00.248Z
60173974-f9a3-5b2b-3b5a-e33979819086,7696,XBt,RealisedPNL,-526497,0,Completed,XBTUSD,46511495-10ca-c6e9-529b-4e961f2ddd09,,2019-04-17T12:00:00.000Z,270593103,2019-04-17T12:00:00.245Z
9d3d900b-8737-213b-1c55-0fd7005081c6,7696,XBt,RealisedPNL,54342,0,Completed,ETHUSD,46511495-10ca-c6e9-529b-4e961f2ddd09,,2019-04-17T12:00:00.000Z,271119600,2019-04-17T12:00:00.245Z
f5d05ebb-ba55-8a0c-84df-4c2ecb083fc4,7696,XBt,RealisedPNL,-3149284,0,Completed,XBTUSD,2d73d938-738b-736e-9225-3c1dedcfeafb,,2019-04-16T12:00:00.000Z,271065258,2019-04-16T12:00:00.258Z
7d378190-e288-88e3-dda1-4b24a8281d93,7696,XBt,RealisedPNL,110780,0,Completed,ETHUSD,2d73d938-738b-736e-9225-3c1dedcfeafb,,2019-04-16T12:00:00.000Z,274214542,2019-04-16T12:00:00.258Z
9e0dcbfe-878a-13df-ed37-85be1c6e6372,7696,XBt,RealisedPNL,-5512477,0,Completed,XBTUSD,481a45ff-38f1-270c-b7b8-ff7b70057252,,2019-04-15T12:00:00.000Z,274103762,2019-04-15T12:00:00.256Z
ab0170ad-8372-4c42-659b-0253034d3851,7696,XBt,RealisedPNL,60391,0,Completed,ETHUSD,481a45ff-38f1-270c-b7b8-ff7b70057252,,2019-04-15T12:00:00.000Z,279616239,2019-04-15T12:00:00.256Z
af6862fe-91c1-0493-1040-231c2a9a4a8d,7696,XBt,RealisedPNL,-5713447,0,Completed,XBTUSD,288ba102-2cae-340c-f89b-d04256bd326e,,2019-04-14T12:00:00.000Z,279555848,2019-04-14T12:00:00.258Z
5ddfacb1-aa50-d81f-79ee-d2f3f7b11833,7696,XBt,RealisedPNL,157425,0,Completed,ETHUSD,288ba102-2cae-340c-f89b-d04256bd326e,,2019-04-14T12:00:00.000Z,285269295,2019-04-14T12:00:00.258Z
0c5749f9-acbc-6bca-a815-82c252e88159,7696,XBt,RealisedPNL,2652129,0,Completed,XBTUSD,b49d44b5-2282-f4c1-f021-5433be5eddba,,2019-04-13T12:00:00.000Z,285111870,2019-04-13T12:00:00.261Z
723e6f03-35e7-4100-b6cf-99ac60ece5da,7696,XBt,RealisedPNL,189617,0,Completed,ETHUSD,b49d44b5-2282-f4c1-f021-5433be5eddba,,2019-04-13T12:00:00.000Z,282459741,2019-04-13T12:00:00.261Z
f0312747-3c4f-e88b-7738-4b0af344afb7,7696,XBt,RealisedPNL,-323377,0,Completed,XBTUSD,ab982e27-85a8-2252-7e31-0ce6a9194049,,2019-04-12T12:00:00.000Z,282270124,2019-04-12T12:00:00.260Z
88b68244-123e-2761-c283-a4efac4911c1,7696,XBt,RealisedPNL,-4621,0,Completed,ETHUSD,ab982e27-85a8-2252-7e31-0ce6a9194049,,2019-04-12T12:00:00.000Z,282593501,2019-04-12T12:00:00.260Z
c482c041-6791-f328-1abe-c2a00facab26,7696,XBt,RealisedPNL,466068,0,Completed,XBTUSD,7a1e1a50-5413-2ac5-9f0a-69abffd049cd,,2019-04-11T12:00:00.000Z,282598122,2019-04-11T12:00:00.236Z
58e56088-e3c7-ee6f-edc7-8c15f67e90d5,7696,XBt,RealisedPNL,-31141,0,Completed,XBTUSD,75f35ff6-e74c-c0a9-0e75-ba2a7f7d0c86,,2019-04-10T12:00:00.000Z,282132054,2019-04-10T12:00:00.301Z
2f0c95a3-c5b5-a10f-e8ae-50556c4aa106,7696,XBt,RealisedPNL,-10905,0,Completed,XBTUSD,dbeed534-f28e-fe95-3a19-fb8263e58f3d,,2019-04-09T12:00:00.000Z,282163195,2019-04-09T12:00:00.259Z
159d0be6-c119-90ca-75fd-d496a239388f,7696,XBt,RealisedPNL,-120668,0,Completed,XBTUSD,0f36660d-3027-205d-d96d-af3993b44f4d,,2019-04-05T12:00:00.000Z,282174100,2019-04-05T12:00:00.294Z
eaca7b7d-2f98-f5c1-6ba0-45a43c8db69d,7696,XBt,RealisedPNL,-4411593,0,Completed,XBTUSD,85792baa-e38e-da64-50da-685d3e408c08,,2019-04-04T12:00:00.000Z,282294768,2019-04-04T12:00:00.249Z
1b874e66-aeb9-f9d6-7bbf-d6756fab0a2e,7696,XBt,RealisedPNL,3377507,0,Completed,XBTUSD,10a6a1a6-ac5b-0ced-5cdb-ea57edcdb234,,2019-04-03T12:00:00.000Z,286706361,2019-04-03T12:00:00.194Z
544f3c0e-d9d2-7d99-994f-4c4cb9efc161,7696,XBt,RealisedPNL,-111589,0,Completed,XBTUSD,8c1d0588-c19d-98f7-6d1a-125a643b0d9d,,2019-04-02T12:00:00.000Z,283328854,2019-04-02T12:00:00.189Z
a1c4c10a-a478-174f-41c1-8066724b1d37,7696,XBt,RealisedPNL,333876,0,Completed,XBTUSD,916dfe60-c425-641f-5883-bb56df2568d4,,2019-04-01T12:00:00.000Z,283440443,2019-04-01T12:00:00.296Z
ba380e8f-44b8-e6cb-d43c-0852dc2c4d98,7696,XBt,RealisedPNL,453854,0,Completed,XBTUSD,a60f29d6-b858-2df5-cc0d-43581e30c96d,,2019-03-31T12:00:00.000Z,283106567,2019-03-31T12:00:00.238Z
2a262d27-029d-2a8d-1ba7-539c8fc5ac1d,7696,XBt,RealisedPNL,132863,0,Completed,XBTUSD,09bf5af6-8335-090b-68bf-a921324f8be4,,2019-03-30T12:00:00.000Z,282652713,2019-03-30T12:00:00.260Z
2a3aa280-09c8-d42a-c908-8419c1eb4dcf,7696,XBt,RealisedPNL,150580,0,Completed,XBTUSD,7311b421-ccfe-a32d-8a6c-de7a1bedcc5e,,2019-03-29T12:00:00.000Z,282519850,2019-03-29T12:00:00.240Z
0423c2b3-450f-40e2-2ead-a63191b6b73c,7696,XBt,RealisedPNL,99439,0,Completed,XBTUSD,6a48bf24-9eab-5bca-43e9-0d4412667bab,,2019-03-28T12:00:00.000Z,282369270,2019-03-28T12:00:00.244Z
cb5737c3-120f-e085-bdb9-ff5633bd1c6a,7696,XBt,RealisedPNL,276267,0,Completed,XBTUSD,a52589f5-c800-84cc-d7f8-a5ac668d0b13,,2019-03-27T12:00:00.000Z,282269831,2019-03-27T12:00:00.264Z
c41b953e-687b-bbfc-2008-00fce56b90ea,7696,XBt,RealisedPNL,15577,0,Completed,ETHUSD,a52589f5-c800-84cc-d7f8-a5ac668d0b13,,2019-03-27T12:00:00.000Z,281993564,2019-03-27T12:00:00.264Z
bb42b2a8-b602-9977-34af-ea7cfef8711f,7696,XBt,RealisedPNL,-11800,0,Completed,XBTUSD,35431f08-74b3-b0ef-b5de-c453d9479922,,2019-03-26T12:00:00.000Z,281977987,2019-03-26T12:00:00.253Z
1ce12a82-9226-5e04-7437-fbf3d8166944,7696,XBt,RealisedPNL,80,0,Completed,ETHUSD,35431f08-74b3-b0ef-b5de-c453d9479922,,2019-03-26T12:00:00.000Z,281989787,2019-03-26T12:00:00.253Z
14953820-310f-830f-424e-e81ecc84e835,7696,XBt,RealisedPNL,-48693,0,Completed,XBTUSD,b5a5425d-124a-71e3-233f-f40d48616179,,2019-03-25T12:00:00.000Z,281989707,2019-03-25T12:00:00.253Z
cbb0110b-08d7-3535-0e93-fba86f03f69c,7696,XBt,RealisedPNL,-586,0,Completed,ETHUSD,b5a5425d-124a-71e3-233f-f40d48616179,,2019-03-25T12:00:00.000Z,282038400,2019-03-25T12:00:00.253Z
3d9c4e02-18b2-ceee-6962-cad3baa78f04,7696,XBt,RealisedPNL,923,0,Completed,XBTUSD,8f3e2b9c-2db8-6d6b-3eed-cdb7f549aeef,,2019-03-24T12:00:00.000Z,282038986,2019-03-24T12:00:00.266Z
af6d45ea-cf3f-9a56-d0a8-51a986b21333,7696,XBt,RealisedPNL,-1883,0,Completed,ETHUSD,8f3e2b9c-2db8-6d6b-3eed-cdb7f549aeef,,2019-03-24T12:00:00.000Z,282038063,2019-03-24T12:00:00.266Z
f5760111-e634-499a-8c8c-88614742d0d7,7696,XBt,RealisedPNL,-69680,0,Completed,XBTUSD,c0ef69d9-0373-4d5f-c904-39e1679423a6,,2019-03-23T12:00:00.000Z,282039946,2019-03-23T12:00:00.279Z
7d1b6b7a-6109-4ea1-dd7b-0c4ea325ea1d,7696,XBt,RealisedPNL,-3312,0,Completed,ETHUSD,c0ef69d9-0373-4d5f-c904-39e1679423a6,,2019-03-23T12:00:00.000Z,282109626,2019-03-23T12:00:00.279Z
8291871c-1614-7708-d772-e778b4b2858b,7696,XBt,RealisedPNL,-135221,0,Completed,XBTUSD,3f661d60-ec68-d9be-d56d-388d61ada0d7,,2019-03-22T12:00:00.000Z,282112938,2019-03-22T12:00:00.299Z
b2de2f63-8071-a97c-2ab5-44694c3836b3,7696,XBt,RealisedPNL,-4133,0,Completed,ETHUSD,3f661d60-ec68-d9be-d56d-388d61ada0d7,,2019-03-22T12:00:00.000Z,282248159,2019-03-22T12:00:00.299Z
e000b937-809b-6c29-3d98-bbdcc56b10d0,7696,XBt,RealisedPNL,-47870,0,Completed,XBTUSD,10e9567e-9963-1095-d335-d46a4b9f0a65,,2019-03-21T12:00:00.000Z,282252292,2019-03-21T12:00:00.310Z
44840afd-4f12-4e9c-0477-bb8a474edf6e,7696,XBt,RealisedPNL,209,0,Completed,ETHUSD,10e9567e-9963-1095-d335-d46a4b9f0a65,,2019-03-21T12:00:00.000Z,282300162,2019-03-21T12:00:00.310Z
a83204bb-f803-b23b-6a1b-8105378e96f3,7696,XBt,RealisedPNL,-21930,0,Completed,XBTUSD,6511a9df-fd3d-4b3a-d791-ee96366e80e8,,2019-03-20T12:00:00.000Z,282299953,2019-03-20T12:00:00.252Z
663cc52b-38db-93ed-16e2-fb3915e7f77d,7696,XBt,RealisedPNL,-4678,0,Completed,ETHUSD,6511a9df-fd3d-4b3a-d791-ee96366e80e8,,2019-03-20T12:00:00.000Z,282321883,2019-03-20T12:00:00.252Z
d45489a9-049a-9bf1-8c50-35a80d9e0756,7696,XBt,RealisedPNL,-60151,0,Completed,XBTUSD,5553935a-a188-0233-33cf-ea3e76d7c08a,,2019-03-19T12:00:00.000Z,282326561,2019-03-19T12:00:00.239Z
5805afef-9ccd-b045-37ea-651ca873bd9c,7696,XBt,RealisedPNL,-2129,0,Completed,ETHUSD,5553935a-a188-0233-33cf-ea3e76d7c08a,,2019-03-19T12:00:00.000Z,282386712,2019-03-19T12:00:00.239Z
72b181bd-51e3-9692-0c60-6cea2f8afc38,7696,XBt,RealisedPNL,144778,0,Completed,XBTUSD,6a232613-122a-7d3e-5a1b-12fcae33a1a6,,2019-03-18T12:00:00.000Z,282388841,2019-03-18T12:00:00.225Z
a02693b9-e30e-fe55-8cc3-dd8dd66727b0,7696,XBt,RealisedPNL,22193,0,Completed,XBTUSD,15b5bfc8-0074-af38-bc71-05219c12077b,,2019-03-17T12:00:00.000Z,282244063,2019-03-17T12:00:00.282Z
f5f16403-98b4-6fb5-f441-70dcda8548d0,7696,XBt,RealisedPNL,9209,0,Close,IndexPrice,XBTUSD,fee7ef5c-7433-9ab3-f80b-967ea29bd6b0,,2019-03-16T12:00:00.000Z,282221870,2019-03-16T12:00:00.292Z
e58a2273-5b08-5e5b-96a4-809a2b750a92,7696,XBt,RealisedPNL,26517,0,Completed,XBTUSD,487a3e92-df0b-4801-46d1-0759228d9874,,2019-03-15T12:00:00.000Z,282221870,2019-03-15T12:00:00.288Z
16b9d1c1-fe0c-f545-36b6-d2ee71b8983b,7696,XBt,RealisedPNL,-18334,0,Close,IndexPrice,XBTUSD,e00c5b05-4565-c478-1987-69cba02930c2,,2019-03-14T12:00:00.000Z,282195353,2019-03-14T12:00:00.222Z
724b4245-47e9-0811-e864-5aa3923885a9,7696,XBt,RealisedPNL,-83945,0,Completed,XBTUSD,e84c2616-d196-da90-6f5c-e8151c66decd,,2019-03-13T12:00:00.000Z,282213687,2019-03-13T12:00:00.236Z
f56491eb-9193-16ad-0adf-e8e2a797cbf2,7696,XBt,RealisedPNL,-7620,0,Completed,ETHUSD,e84c2616-d196-da90-6f5c-e8151c66decd,,2019-03-13T12:00:00.000Z,282297632,2019-03-13T12:00:00.236Z
46919594-c3ac-4c03-d676-fd6d53d6a16e,7696,XBt,RealisedPNL,13345,0,Completed,XBTUSD,aa468dcd-4e9b-d5c3-c8ef-509627c94815,,2019-03-12T12:00:00.000Z,282305252,2019-03-12T12:00:00.280Z
9f711e8c-bd29-5db1-45d8-2f5e067f5475,7696,XBt,RealisedPNL,3822,0,Completed,ETHUSD,aa468dcd-4e9b-d5c3-c8ef-509627c94815,,2019-03-12T12:00:00.000Z,282291907,2019-03-12T12:00:00.280Z
fdbf320e-2155-342b-0bd5-5600d1aca59b,7696,XBt,RealisedPNL,25785,0,Completed,XBTUSD,b7de2363-e4b5-da8f-6b6c-56d865556b6c,,2019-03-11T12:00:00.000Z,282288085,2019-03-11T12:00:00.256Z
27ad80e0-cef5-d794-ee53-d37ae3918164,7696,XBt,RealisedPNL,3519,0,Completed,ETHUSD,b7de2363-e4b5-da8f-6b6c-56d865556b6c,,2019-03-11T12:00:00.000Z,282262300,2019-03-11T12:00:00.256Z
ee175bee-96b7-bb7b-7269-28760c52343c,7696,XBt,RealisedPNL,4706,0,Completed,ETHUSD,875b7bb1-4fa4-002c-d30b-1e70119120f5,,2019-03-10T12:00:00.000Z,282258781,2019-03-10T12:00:00.264Z
a2cf57f0-3245-a309-a784-6f2b3131f745,7696,XBt,RealisedPNL,5920,0,Completed,ETHUSD,60e9b2ce-986a-59e8-991f-19d117d35256,,2019-03-09T12:00:00.000Z,282254075,2019-03-09T12:00:00.247Z
9654f096-af81-5e1a-eb77-b3050edf4b15,7696,XBt,RealisedPNL,-1026075,0,Completed,XBTUSD,f3e2deb1-3e90-d81f-b545-eef32e6e94fe,,2019-03-08T12:00:00.000Z,282248155,2019-03-08T12:00:00.263Z
a69e333c-a8f8-2bcc-12d0-980feb358458,7696,XBt,RealisedPNL,6121,0,Completed,ETHUSD,f3e2deb1-3e90-d81f-b545-eef32e6e94fe,,2019-03-08T12:00:00.000Z,283274230,2019-03-08T12:00:00.263Z
5b4360e4-4431-e129-c00f-1d3e887985e1,7696,XBt,RealisedPNL,6506588,0,Completed,XBTUSD,f5601723-3462-4acf-e102-25b949871b35,,2019-03-07T12:00:00.000Z,283268109,2019-03-07T12:00:00.248Z
300559e5-85dc-f557-fc48-dd6451f343e0,7696,XBt,RealisedPNL,7530405,0,Completed,ETHUSD,f5601723-3462-4acf-e102-25b949871b35,,2019-03-07T12:00:00.000Z,276761521,2019-03-07T12:00:00.248Z
ac69ae9b-6b40-9140-7680-4b63917a2f0e,7696,XBt,RealisedPNL,-5982684,0,Completed,XBTUSD,397e4dfc-b845-4b4b-2b3c-16a096a27f33,,2019-03-06T12:00:00.000Z,269231116,2019-03-06T12:00:00.260Z
2939927b-714e-aa27-0379-6f2a7bb8e7ed,7696,XBt,RealisedPNL,-107948,0,Completed,ETHUSD,397e4dfc-b845-4b4b-2b3c-16a096a27f33,,2019-03-06T12:00:00.000Z,275213800,2019-03-06T12:00:00.260Z
1d5f8aa5-81d9-4cb8-6f58-8db46d38cbc5,7696,XBt,RealisedPNL,-1214027,0,Completed,XBTUSD,fd7a4ad3-b2ae-6cc5-6765-7c302b0a3a12,,2019-03-05T12:00:00.000Z,275321748,2019-03-05T12:00:00.246Z
c6fbf2b0-38e8-7f26-a626-e89da8b7df59,7696,XBt,RealisedPNL,-3798,0,Completed,ETHUSD,fd7a4ad3-b2ae-6cc5-6765-7c302b0a3a12,,2019-03-05T12:00:00.000Z,276535775,2019-03-05T12:00:00.246Z
32f7a85a-4e1f-cfea-4560-0af229fc8e6a,7696,XBt,RealisedPNL,158,0,Completed,XBTUSD,6b58a5ea-dff0-074b-f857-3c3aa88fefcc,,2019-03-04T12:00:00.000Z,276539573,2019-03-04T12:00:00.266Z
20c33d65-87f7-6758-c779-5b6b2cbc316a,7696,XBt,RealisedPNL,3258,0,Completed,ETHUSD,6b58a5ea-dff0-074b-f857-3c3aa88fefcc,,2019-03-04T12:00:00.000Z,276539415,2019-03-04T12:00:00.266Z
f69783f1-dcd5-bbc3-7c26-efff7d2970d7,7696,XBt,RealisedPNL,409,0,Completed,XBTUSD,791bf74a-5eb8-2ed5-eb58-277a133e4082,,2019-03-03T12:00:00.000Z,276536157,2019-03-03T12:00:00.231Z
08fdd126-0f82-5a81-2f04-cfc3694cde08,7696,XBt,RealisedPNL,-7207,0,Completed,ETHUSD,791bf74a-5eb8-2ed5-eb58-277a133e4082,,2019-03-03T12:00:00.000Z,276535748,2019-03-03T12:00:00.231Z
296c817a-ed23-5158-c525-540e6eb54652,7696,XBt,RealisedPNL,161,0,Completed,XBTUSD,b8633b0c-0faa-7684-135a-4cbba586e4dc,,2019-03-02T12:00:00.000Z,276542955,2019-03-02T12:00:00.261Z
aede5354-b168-7abf-795a-9b58917896f3,7696,XBt,RealisedPNL,-12213,0,Completed,ETHUSD,b8633b0c-0faa-7684-135a-4cbba586e4dc,,2019-03-02T12:00:00.000Z,276542794,2019-03-02T12:00:00.261Z
b8328b67-f747-4bc2-1e15-2b1b24e13dc2,7696,XBt,RealisedPNL,65,0,Completed,XBTUSD,d7d6ba38-582c-8948-8226-31f0cea0033d,,2019-03-01T12:00:00.000Z,276555007,2019-03-01T12:00:00.288Z
c0b29d2f-9b84-fa59-8803-66a2ec6e972e,7696,XBt,RealisedPNL,31222,0,Completed,ETHUSD,d7d6ba38-582c-8948-8226-31f0cea0033d,,2019-03-01T12:00:00.000Z,276554942,2019-03-01T12:00:00.288Z
f62c27a0-4573-15ef-e9ef-f43978cef28b,7696,XBt,RealisedPNL,3426,0,Completed,XBTUSD,b114810c-a6eb-2706-8e0d-0d7d1951cd9d,,2019-02-28T12:00:00.000Z,276523720,2019-02-28T12:00:00.280Z
0ac44c8e-ef09-0c30-88aa-31c53a7d338c,7696,XBt,RealisedPNL,1027,0,Completed,ETHUSD,b114810c-a6eb-2706-8e0d-0d7d1951cd9d,,2019-02-28T12:00:00.000Z,276520294,2019-02-28T12:00:00.280Z
36b57570-876a-b600-f565-16ead2f76c63,7696,XBt,RealisedPNL,527284,0,Completed,XBTUSD,172324c9-fe44-97c6-030d-65d5e3f573c6,,2019-02-27T12:00:00.000Z,276519267,2019-02-27T12:00:00.267Z
b66602c0-31de-ef26-85f1-57d49614a51d,7696,XBt,RealisedPNL,-3715,0,Completed,ETHUSD,172324c9-fe44-97c6-030d-65d5e3f573c6,,2019-02-27T12:00:00.000Z,275991983,2019-02-27T12:00:00.267Z
78717fe8-fa6c-fc5a-4a89-83940e410ecd,7696,XBt,RealisedPNL,-44457,0,Completed,XBTUSD,d4cd6f7e-d370-2982-782c-23ba7dd4c751,,2019-02-26T12:00:00.000Z,275995698,2019-02-26T12:00:00.190Z
7b807597-95fe-5d27-d96f-95cabc8f51fd,7696,XBt,RealisedPNL,-3776,0,Completed,ETHUSD,d4cd6f7e-d370-2982-782c-23ba7dd4c751,,2019-02-26T12:00:00.000Z,276040155,2019-02-26T12:00:00.190Z
81db6b34-9fe5-7015-f977-82e8e1d26989,7696,XBt,RealisedPNL,37956,0,Completed,XBTUSD,860e3efc-f157-29ba-4d65-1bf937ce16c5,,2019-02-25T12:00:00.000Z,276043931,2019-02-25T12:00:00.182Z
56c82212-7556-0f1c-9639-62fc9f1a05b4,7696,XBt,RealisedPNL,11299,0,Completed,ETHUSD,860e3efc-f157-29ba-4d65-1bf937ce16c5,,2019-02-25T12:00:00.000Z,276005975,2019-02-25T12:00:00.182Z
7dccf114-143c-af93-6a76-970ea00d3e3f,7696,XBt,RealisedPNL,42518,0,Completed,XBTUSD,eb90de45-afa9-cbee-7d08-ac48ab034015,,2019-02-24T12:00:00.000Z,275994676,2019-02-24T12:00:00.246Z
4c424896-bd9a-1e8f-451b-14e8108eefc0,7696,XBt,RealisedPNL,8902,0,Completed,ETHUSD,eb90de45-afa9-cbee-7d08-ac48ab034015,,2019-02-24T12:00:00.000Z,275952158,2019-02-24T12:00:00.246Z
3aca8591-cd3f-f3df-9b35-c1dcf6337d99,7696,XBt,RealisedPNL,-325,0,Completed,XBTUSD,25597460-7a18-db40-9c1a-3c0079ff32fd,,2019-02-23T12:00:00.000Z,275943256,2019-02-23T12:00:00.241Z
5b495e18-a403-cd6d-660f-d466e0b4e4aa,7696,XBt,RealisedPNL,8394,0,Completed,ETHUSD,25597460-7a18-db40-9c1a-3c0079ff32fd,,2019-02-23T12:00:00.000Z,275943581,2019-02-23T12:00:00.241Z
c5d6629f-d52e-45ca-8d1b-3520ed36d777,7696,XBt,RealisedPNL,-19720,0,Completed,XBTUSD,b92512ee-9e61-6cc9-bcbf-97e38f6d8eba,,2019-02-22T12:00:00.000Z,275935187,2019-02-22T12:00:00.261Z
155db6c6-9d08-ab56-a1b8-3b2cadba1785,7696,XBt,RealisedPNL,10569,0,Completed,ETHUSD,b92512ee-9e61-6cc9-bcbf-97e38f6d8eba,,2019-02-22T12:00:00.000Z,275954907,2019-02-22T12:00:00.261Z
b77e6563-88a6-6e22-4d5d-3037cd631cb6,7696,XBt,RealisedPNL,43543,0,Completed,XBTUSD,248ca591-d4c1-72da-bdb0-ea0a4c1e3495,,2019-02-21T12:00:00.000Z,275944338,2019-02-21T12:00:00.293Z
5d57852e-77d2-fd2e-2e67-03b02e0cbcfb,7696,XBt,RealisedPNL,13639,0,Completed,ETHUSD,248ca591-d4c1-72da-bdb0-ea0a4c1e3495,,2019-02-21T12:00:00.000Z,275900795,2019-02-21T12:00:00.293Z
27efe231-a29d-12a1-4fd0-854cfbdd698d,7696,XBt,RealisedPNL,50103,0,Completed,XBTUSD,81453b34-a624-10f1-f7ea-06fd400171af,,2019-02-20T12:00:00.000Z,275887156,2019-02-20T12:00:00.270Z
99a3130a-af33-ed29-9f2d-e487e2c92a14,7696,XBt,RealisedPNL,15889,0,Completed,ETHUSD,81453b34-a624-10f1-f7ea-06fd400171af,,2019-02-20T12:00:00.000Z,275837053,2019-02-20T12:00:00.270Z
e9006166-6c2c-43e3-006a-3b20332c66e8,7696,XBt,RealisedPNL,48424,0,Completed,XBTUSD,2051bfbd-9b4f-42b1-b858-1b3f5d1f1176,,2019-02-19T12:00:00.000Z,275821164,2019-02-19T12:00:00.249Z
ef5ac24d-0a07-1113-1a08-d68d0fa68797,7696,XBt,RealisedPNL,6741,0,Completed,ETHUSD,2051bfbd-9b4f-42b1-b858-1b3f5d1f1176,,2019-02-19T12:00:00.000Z,275772740,2019-02-19T12:00:00.249Z
fa73020a-339d-5b9e-ca31-f8284df60ca7,7696,XBt,RealisedPNL,12485,0,Completed,XBTUSD,8cfe2dc3-54ff-81ea-2908-022df1081b1a,,2019-02-18T12:00:00.000Z,275765999,2019-02-18T12:00:00.280Z
371efff4-0ab4-8f72-6c07-dbf6330b72b0,7696,XBt,RealisedPNL,8312,0,Completed,ETHUSD,8cfe2dc3-54ff-81ea-2908-022df1081b1a,,2019-02-18T12:00:00.000Z,275753514,2019-02-18T12:00:00.280Z
d095d63c-58f4-589e-a594-6994acd46348,7696,XBt,RealisedPNL,12397,0,Completed,XBTUSD,4b186fee-d235-0772-4c44-5f3b882e4a0a,,2019-02-17T12:00:00.000Z,275745202,2019-02-17T12:00:00.211Z
444e0d85-c23f-1de8-1f0e-f2ce33f53184,7696,XBt,RealisedPNL,11682,0,Completed,ETHUSD,4b186fee-d235-0772-4c44-5f3b882e4a0a,,2019-02-17T12:00:00.000Z,275732805,2019-02-17T12:00:00.211Z
97b5fe0f-a61c-c9b9-c089-764cde933325,7696,XBt,RealisedPNL,20145,0,Completed,XBTUSD,1ead470e-5d90-323c-9cba-90d8662004f5,,2019-02-16T12:00:00.000Z,275721123,2019-02-16T12:00:00.220Z
92c82b05-22d3-cfcc-b67d-d173dd464184,7696,XBt,RealisedPNL,12772,0,Completed,ETHUSD,1ead470e-5d90-323c-9cba-90d8662004f5,,2019-02-16T12:00:00.000Z,275700978,2019-02-16T12:00:00.220Z
6b9e6d58-f5e4-f29d-12b6-231a821074c1,7696,XBt,RealisedPNL,43135,0,Completed,XBTUSD,2b50ae86-96d8-c046-e4c8-b950bc5aca53,,2019-02-15T12:00:00.000Z,275688206,2019-02-15T12:00:00.221Z
a3e91be2-a1b4-d4ef-7bb8-7f1d0c7a6110,7696,XBt,RealisedPNL,13365,0,Completed,ETHUSD,2b50ae86-96d8-c046-e4c8-b950bc5aca53,,2019-02-15T12:00:00.000Z,275645071,2019-02-15T12:00:00.221Z
601eb102-35c9-78ba-e766-bcfc73894bd2,7696,XBt,RealisedPNL,51748,0,Completed,XBTUSD,42d8f9e5-e2d6-1169-052e-b32995fab005,,2019-02-14T12:00:00.000Z,275631706,2019-02-14T12:00:00.189Z
ba7344c3-8241-4cd0-6924-529dce28221c,7696,XBt,RealisedPNL,12833,0,Completed,ETHUSD,42d8f9e5-e2d6-1169-052e-b32995fab005,,2019-02-14T12:00:00.000Z,275579958,2019-02-14T12:00:00.189Z
93b27e1e-5b04-a8d1-7c6f-1b8ff2bf5758,7696,XBt,RealisedPNL,26678,0,Completed,XBTUSD,ee52b13e-4c12-4b72-8796-203436f999a1,,2019-02-13T12:00:00.000Z,275567125,2019-02-13T12:00:00.234Z
4f1e37a0-d43a-9428-9362-153f181081c6,7696,XBt,RealisedPNL,12787,0,Completed,ETHUSD,ee52b13e-4c12-4b72-8796-203436f999a1,,2019-02-13T12:00:00.000Z,275540447,2019-02-13T12:00:00.234Z
a7d30d28-aed5-2c05-8194-a4f500e92e03,7696,XBt,RealisedPNL,50870,0,Completed,XBTUSD,0874cd6f-e4a8-5137-1e3f-4a7fc31b8ef4,,2019-02-12T12:00:00.000Z,275527660,2019-02-12T12:00:00.185Z
b7f51788-2ffd-1422-2c3c-f9864a1b5a7f,7696,XBt,RealisedPNL,4029,0,Completed,ETHUSD,0874cd6f-e4a8-5137-1e3f-4a7fc31b8ef4,,2019-02-12T12:00:00.000Z,275476790,2019-02-12T12:00:00.185Z
1f1723a3-3ed7-1621-b93d-0d4eee1aff65,7696,XBt,RealisedPNL,46273,0,Completed,XBTUSD,3360c5d8-d319-a843-5cde-30bad7abda83,,2019-02-11T12:00:00.000Z,275472761,2019-02-11T12:00:00.215Z
809a49f4-af69-b26c-1f0b-cf3eb7103870,7696,XBt,RealisedPNL,49822,0,Completed,XBTUSD,84dcf5a1-273d-7b64-c102-cfc11cb39526,,2019-02-10T12:00:00.000Z,275426488,2019-02-10T12:00:00.295Z
acae24a9-3ba4-6006-69a4-cafceb437252,7696,XBt,RealisedPNL,24965,0,Completed,XBTUSD,97af069a-2e56-58ca-9ab2-fad4cb03ae6c,,2019-02-09T12:00:00.000Z,275376666,2019-02-09T12:00:00.256Z
3c41b47e-03f8-c63d-da64-affd3e649f9f,7696,XBt,RealisedPNL,-6282,0,Completed,XBTUSD,5c5083f1-5d5c-30f8-2261-ec53febfcdb7,,2019-02-08T12:00:00.000Z,275351701,2019-02-08T12:00:00.280Z
36e5012d-857f-5144-8476-9cae46448584,7696,XBt,RealisedPNL,146639,0,Completed,XBTUSD,4f210e1d-7a29-e431-465b-e8c644b54c31,,2019-02-07T12:00:00.000Z,275357983,2019-02-07T12:00:00.260Z
fdf58518-b73c-6711-c046-1421adac05db,7696,XBt,RealisedPNL,2636,0,Completed,XBTUSD,bdc58b51-42ae-45a4-efb6-4c5e8cb4d6c9,,2019-02-06T12:00:00.000Z,275211344,2019-02-06T12:00:00.233Z
a2cdddb3-9d98-b33c-8ad7-e1fa0a418698,7696,XBt,RealisedPNL,22058,0,Completed,XBTUSD,2301be11-7cfa-e189-0f2f-4b277c138a9b,,2019-02-05T12:00:00.000Z,275208708,2019-02-05T12:00:00.233Z
a1379042-ff6b-f661-f788-72b3d97404f1,7696,XBt,RealisedPNL,-24031,0,Completed,XBTUSD,fbfcdeb9-b8c6-7d51-fbae-1e2504874647,,2019-02-04T12:00:00.000Z,275186650,2019-02-04T12:00:00.218Z
64adcaec-0da9-ca29-af91-6d491e8f4885,7696,XBt,RealisedPNL,-48081,0,Completed,XBTUSD,43e866bf-e5ee-c225-5a85-8a08bd89e735,,2019-02-03T12:00:00.000Z,275210681,2019-02-03T12:00:00.227Z
286a0fb4-7449-3697-68c9-b8caac74c4fa,7696,XBt,RealisedPNL,-24866,0,Completed,XBTUSD,dcf6a6a0-8a5a-7086-ed4a-8f7eee507da4,,2019-02-02T12:00:00.000Z,275258762,2019-02-02T12:00:00.221Z
c1a1fc48-b187-f121-bdf9-05a554de3292,7696,XBt,RealisedPNL,-41538,0,Completed,XBTUSD,ebd17a62-fc13-fb76-6860-8034fd959ecb,,2019-02-01T12:00:00.000Z,275283628,2019-02-01T12:00:00.282Z
8204390f-f135-0b8c-8dc2-19a9e06840ba,7696,XBt,RealisedPNL,-7129,0,Completed,XBTUSD,0e0ad13d-001c-3ff4-c3c2-b5c0a0360464,,2019-01-31T12:00:00.000Z,275325166,2019-01-31T12:00:00.221Z
5b0c276f-36c6-b095-44b8-e3a3b0638b3c,7696,XBt,RealisedPNL,807,0,Completed,XBTUSD,e0604596-f79b-5dc0-cb61-e98a463c1476,,2019-01-30T12:00:00.000Z,275332295,2019-01-30T12:00:00.284Z
14f3d85a-b08f-70fe-c349-2e8f67866529,7696,XBt,RealisedPNL,1146,0,Completed,XBTUSD,9829434c-92b4-1985-0c65-46d2580dcae9,,2019-01-29T12:00:00.000Z,275331488,2019-01-29T12:00:00.220Z
cfa8bfd7-6d62-02fd-6dbe-855f186b468c,7696,XBt,RealisedPNL,-503,0,Completed,XBTUSD,e4eade52-5ee6-50eb-e3f1-8eb235e8fba0,,2019-01-28T12:00:00.000Z,275330342,2019-01-28T12:00:00.234Z
31d8bdff-cc00-1e7f-2143-919388002e5e,7696,XBt,RealisedPNL,-1253,0,Completed,XBTUSD,ede23053-99fa-d169-2364-a625c421c70c,,2019-01-27T12:00:00.000Z,275330845,2019-01-27T12:00:00.230Z
26fbebda-8b1f-873d-6b22-dda71a0c5a4c,7696,XBt,RealisedPNL,324,0,Completed,XBTUSD,e598574d-417b-edf5-4e74-d5593ace1733,,2019-01-26T12:00:00.000Z,275332098,2019-01-26T12:00:00.233Z
b6b427f0-0145-bb9c-f207-2b0094ba0d9a,7696,XBt,RealisedPNL,-3167907,0,Completed,XBTUSD,63208103-753b-2767-759b-f940e4a251f0,,2019-01-23T12:00:00.000Z,275331774,2019-01-23T12:00:00.243Z
68271c15-d8c1-8dd3-52ae-bd20dd1adb34,7696,XBt,RealisedPNL,315142,0,Completed,XBTUSD,8c26da8b-f383-2c06-86b8-f0961d72ebeb,,2019-01-22T12:00:00.000Z,278499681,2019-01-22T12:00:00.231Z
552fb99f-ca31-5994-20d8-9a42ac57d944,7696,XBt,RealisedPNL,439200,0,Completed,XBTUSD,817728ec-44d1-037a-121e-72401a8b96d3,,2019-01-21T12:00:00.000Z,278184539,2019-01-21T12:00:00.252Z
3a67c69e-6252-b5c9-faa6-cde4c0a0dd99,7696,XBt,RealisedPNL,203498,0,Completed,XBTUSD,797327ce-2f38-d6ff-6788-10c39ed9e191,,2019-01-20T12:00:00.000Z,277745339,2019-01-20T12:00:00.249Z
afb4c90c-3d70-46ba-b0f2-eccdd315df9e,7696,XBt,RealisedPNL,182821,0,Completed,XBTUSD,94912d0f-ec35-6f9a-bc89-16d08f812310,,2019-01-19T12:00:00.000Z,277541841,2019-01-19T12:00:00.225Z
7db9f19d-185b-236d-723a-73cca588bbc8,7696,XBt,RealisedPNL,-50318,0,Completed,XBTUSD,7e48be51-4f5d-6c75-99d6-681770ffe55b,,2019-01-18T12:00:00.000Z,277359020,2019-01-18T12:00:00.233Z
52773e9f-a9ec-2d56-954b-4902909d8e30,7696,XBt,RealisedPNL,272151,0,Completed,XBTUSD,03e8ec17-8264-0108-5934-e8e56bcdabd0,,2019-01-17T12:00:00.000Z,277409338,2019-01-17T12:00:00.275Z
9c887707-c85f-ec80-05c4-02a5deb98b16,7696,XBt,RealisedPNL,406153,0,Completed,XBTUSD,773968b5-6ebb-ec72-28b6-2149fa0f5dcf,,2019-01-16T12:00:00.000Z,277137187,2019-01-16T12:00:00.290Z
73ebfc84-cd13-0dd4-bb7e-5994e0c11f60,7696,XBt,RealisedPNL,-259353,0,Completed,XBTUSD,0b8bf524-c18b-cd6d-8098-ee6d62ce8e34,,2019-01-15T12:00:00.000Z,276731034,2019-01-15T12:00:00.276Z
6d9dfc15-0925-4438-0d34-4b603cdc80ce,7696,XBt,RealisedPNL,-204421,0,Completed,XBTUSD,2fc453e8-352d-6d26-72d4-c3950a9ca832,,2019-01-14T12:00:00.000Z,276990387,2019-01-14T12:00:00.331Z
77abac4b-ec53-02fd-d8f0-81108c6aa2e3,7696,XBt,RealisedPNL,449610,0,Completed,XBTUSD,db07d35a-8d97-f133-38ec-15111f4beaee,,2019-01-13T12:00:00.000Z,277194808,2019-01-13T12:00:00.307Z
7efd7e68-41be-c830-ef7f-fabcf1880e3e,7696,XBt,RealisedPNL,-289652,0,Completed,XBTUSD,b2fb8b42-495c-0ab8-f111-a341a99aac03,,2019-01-12T12:00:00.000Z,276745198,2019-01-12T12:00:00.280Z
f0f4048a-f933-6a5c-1697-55d52649fe83,7696,XBt,RealisedPNL,-5538,0,Completed,XBTUSD,1ade77f6-34aa-9427-40a5-bc06bf527099,,2019-01-11T12:00:00.000Z,277034850,2019-01-11T12:00:00.238Z
1c21357c-5126-3644-6828-37a0061b09cd,7696,XBt,RealisedPNL,67971,0,Completed,XBTUSD,263765ef-25b1-4789-b588-2ac53767aacb,,2019-01-10T12:00:00.000Z,277040388,2019-01-10T12:00:00.277Z
14807314-afb2-2b7d-ddd3-2c9223d4a7fa,7696,XBt,RealisedPNL,357011,0,Completed,XBTUSD,e36f9d1a-7939-bbc5-8b2a-b658395d3032,,2019-01-09T12:00:00.000Z,276972417,2019-01-09T12:00:00.284Z
ee502893-5779-0563-6acb-10c073ae6bfe,7696,XBt,RealisedPNL,465349,0,Completed,XBTUSD,448a178a-8ad1-9a23-195d-10885d27a5e2,,2019-01-08T12:00:00.000Z,276615406,2019-01-08T12:00:00.246Z
f108b10b-f7c7-31be-a409-b1982c12e29b,7696,XBt,RealisedPNL,34531,0,Completed,XBTUSD,7e1355b8-3cbd-9789-1a90-eac619589783,,2019-01-07T12:00:00.000Z,276150057,2019-01-07T12:00:00.295Z
9cbb6600-b656-cbc2-6710-7c150162befd,7696,XBt,RealisedPNL,-129134,0,Completed,XBTUSD,bceb7951-1b2c-6bb9-2f6b-d86acd6430bb,,2019-01-06T12:00:00.000Z,276115526,2019-01-06T12:00:00.235Z
bfed29e3-da90-4b48-6c21-e756892187bd,7696,XBt,RealisedPNL,289446,0,Completed,XBTUSD,047626b6-f10b-7554-bac1-bdda67692937,,2019-01-05T12:00:00.000Z,276244660,2019-01-05T12:00:00.242Z
c04c4217-b297-920e-b428-0127ea19a197,7696,XBt,RealisedPNL,458354,0,Completed,XBTUSD,f87594b0-10d2-9a0d-6625-c69792cde2a7,,2019-01-04T12:00:00.000Z,275955214,2019-01-04T12:00:00.271Z
8eeb6f18-ccae-37d7-72a8-5743a2ff1608,7696,XBt,RealisedPNL,486534,0,Completed,XBTUSD,73928b1d-b177-5a96-89f5-945baf518424,,2019-01-03T12:00:00.000Z,275496860,2019-01-03T12:00:00.253Z
9ab561ac-a015-30ae-e1b3-edd240c27735,7696,XBt,RealisedPNL,-114617,0,Completed,XBTUSD,26657027-5216-986a-6881-974ea1e61068,,2019-01-02T12:00:00.000Z,275010326,2019-01-02T12:00:00.265Z
d82a7def-e3a2-6ab1-b404-92ebfddcf622,7696,XBt,RealisedPNL,121925,0,Completed,XBTUSD,1561f2ae-4029-1de7-aa7e-947d741c1344,,2019-01-01T12:00:00.000Z,275124943,2019-01-01T12:00:00.233Z
3ba3c6a2-bf65-e13b-8532-1b7b8243dacf,7696,XBt,RealisedPNL,355018,0,Completed,XBTUSD,6f97313e-f3f1-aa74-8737-cf9ca486b602,,2018-12-31T12:00:00.000Z,275003018,2018-12-31T12:00:00.283Z
a80f6f24-4609-b3ca-2d0e-f8e79cbe0f17,7696,XBt,RealisedPNL,490449,0,Completed,XBTUSD,92d27121-a0f6-3075-d50b-8d234d34f026,,2018-12-30T12:00:00.000Z,274648000,2018-12-30T12:00:00.229Z
2d4a894d-38c1-28fa-dfc5-2446c104e191,7696,XBt,RealisedPNL,492162,0,Completed,XBTUSD,7ae6c406-5777-8a62-7d54-6b0ed7b57951,,2018-12-29T12:00:00.000Z,274157551,2018-12-29T12:00:00.238Z
24e73693-e03c-f24a-7c85-4d3078afdc49,7696,XBt,RealisedPNL,512274,0,Completed,XBTUSD,7a7f443f-d868-7c5c-83f6-8cd2bbf7974f,,2018-12-28T12:00:00.000Z,273665389,2018-12-28T12:00:00.247Z
bd068aaf-c2e2-9abd-79ea-2fc7179a3b8d,7696,XBt,RealisedPNL,496830,0,Completed,XBTUSD,a82e9733-b9b5-be47-a06c-086ae9e3c025,,2018-12-27T12:00:00.000Z,273153115,2018-12-27T12:00:00.227Z
45b60ed7-29fc-719a-df34-a961f2c47075,7696,XBt,RealisedPNL,494836,0,Completed,XBTUSD,c06ad6e5-aef1-53e2-b137-b105b10f4565,,2018-12-26T12:00:00.000Z,272656285,2018-12-26T12:00:00.237Z
5c049255-27a5-016c-6247-ae0cfc474b50,7696,XBt,RealisedPNL,403067,0,Completed,XBTUSD,d033e026-591e-ec61-0be0-baffc50d86ba,,2018-12-25T12:00:00.000Z,272161449,2018-12-25T12:00:00.300Z
16728ec3-c7d4-c18f-8507-79f401f2b8a6,7696,XBt,RealisedPNL,462022,0,Completed,XBTUSD,81e68ff3-3e80-49d0-af46-5507e9135c47,,2018-12-24T12:00:00.000Z,271758382,2018-12-24T12:00:00.242Z
c53a971d-d058-a351-24b1-8c3ca44b79c3,7696,XBt,RealisedPNL,476375,0,Completed,XBTUSD,9c9f7b0b-59b9-870a-a66d-d947c8daf18d,,2018-12-23T12:00:00.000Z,271296360,2018-12-23T12:00:00.267Z
b37139b7-1ea5-fe7c-9aec-898b7939b391,7696,XBt,RealisedPNL,481379,0,Completed,XBTUSD,b47900c1-3f86-21a5-1d4f-68b7efcbce16,,2018-12-22T12:00:00.000Z,270819985,2018-12-22T12:00:00.313Z
66daee2e-bf33-d8a0-aca1-1193f69bb43c,7696,XBt,RealisedPNL,463050,0,Completed,XBTUSD,0767c698-8e56-882c-acfc-f6198515051f,,2018-12-21T12:00:00.000Z,270338606,2018-12-21T12:00:00.242Z
5c0138b8-ceb1-6c27-bfe4-375385e6cc27,7696,XBt,RealisedPNL,496494,0,Completed,XBTUSD,f23e758e-8e0d-7248-aa21-1e27d9042c14,,2018-12-20T12:00:00.000Z,269875556,2018-12-20T12:00:00.239Z
54c8e8b5-b7c0-e73d-357a-5cba7ee3a752,7696,XBt,RealisedPNL,359537,0,Completed,XBTUSD,b8a721d4-dee0-7007-7027-9a84c3305c07,,2018-12-19T12:00:00.000Z,269379062,2018-12-19T12:00:00.223Z
cad0d2eb-b8a8-0840-d842-4f48d721863c,7696,XBt,RealisedPNL,505819,0,Completed,XBTUSD,52995478-eb61-12a3-8c05-4246a51e0f4d,,2018-12-18T12:00:00.000Z,269019525,2018-12-18T12:00:00.237Z
410bddc8-318e-9def-67d8-b3083df196c8,7696,XBt,RealisedPNL,538067,0,Completed,XBTUSD,3dd3c204-29b8-7d66-d4fc-f45bd42ce430,,2018-12-17T12:00:00.000Z,268513706,2018-12-17T12:00:00.265Z
ea6e8a99-e8e1-b89c-f626-141eecae9cee,7696,XBt,RealisedPNL,543833,0,Completed,XBTUSD,cf068438-46d4-ce88-be7b-5f1cadd92360,,2018-12-16T12:00:00.000Z,267975639,2018-12-16T12:00:00.233Z
17fd8694-a19f-9257-d32d-aa5ec82f20a5,7696,XBt,RealisedPNL,539178,0,Completed,XBTUSD,88233760-b86c-38be-4253-3ebb7c2ebb17,,2018-12-15T12:00:00.000Z,267431806,2018-12-15T12:00:00.225Z
afdaa93d-ad3b-10c1-2030-585264da00b3,7696,XBt,RealisedPNL,524438,0,Completed,XBTUSD,698e299c-984d-e023-9df6-f70e5f148c27,,2018-12-14T12:00:00.000Z,266892628,2018-12-14T12:00:00.260Z
a74f8069-d7bf-ecae-10d3-4fbab089133d,7696,XBt,RealisedPNL,508664,0,Completed,XBTUSD,a42c3bfd-a6d1-9b12-22f4-6c6034d0cb56,,2018-12-13T12:00:00.000Z,266368190,2018-12-13T12:00:00.222Z
d8b20c36-e105-cb65-6f8d-c00e4d8e2c46,7696,XBt,RealisedPNL,505258,0,Completed,XBTUSD,387d84df-e7b2-846e-9434-3a1263172258,,2018-12-12T12:00:00.000Z,265859526,2018-12-12T12:00:00.237Z
734866e2-8721-0f6e-1678-dd131594bbb3,7696,XBt,RealisedPNL,494420,0,Completed,XBTUSD,4a945201-249d-6be1-fa1b-a1a5494531fe,,2018-12-11T12:00:00.000Z,265354268,2018-12-11T12:00:00.247Z
e9197753-6ae1-94b5-3d74-c9e8f93edef0,7696,XBt,RealisedPNL,481889,0,Completed,XBTUSD,ba2e02d8-8ca7-a0c7-95b0-795a941a3d9c,,2018-12-10T12:00:00.000Z,264859848,2018-12-10T12:00:00.258Z
eca28fdf-5c9f-bfa9-7f21-738d755dec13,7696,XBt,RealisedPNL,498425,0,Completed,XBTUSD,77fb8bb0-b73f-96ed-4138-1c36d06b8277,,2018-12-09T12:00:00.000Z,264377959,2018-12-09T12:00:00.258Z
64b2af7b-3418-4fac-3ff9-2c6255243f65,7696,XBt,RealisedPNL,492545,0,Completed,XBTUSD,fdc7a4ef-9ae7-7dc4-0db3-736eacc1026c,,2018-12-08T12:00:00.000Z,263879534,2018-12-08T12:00:00.273Z
5c3527b1-2de8-d1b9-b7ea-a72af4a251d7,7696,XBt,RealisedPNL,208472,0,Completed,XBTUSD,452d2bb5-561f-e2ce-4f5b-e4604b2b3872,,2018-12-07T12:00:00.000Z,263386989,2018-12-07T12:00:00.217Z
f6136e11-1cb7-7886-3be6-0db1ba462f3a,7696,XBt,RealisedPNL,-8294,0,Completed,ETHUSD,452d2bb5-561f-e2ce-4f5b-e4604b2b3872,,2018-12-07T12:00:00.000Z,263178517,2018-12-07T12:00:00.217Z
6b63b4f5-6178-131d-9e3f-65277036d408,7696,XBt,RealisedPNL,461351,0,Completed,XBTUSD,8069edd0-9b0b-fa15-6a1f-651950d0d346,,2018-12-06T12:00:00.000Z,263186811,2018-12-06T12:00:00.241Z
758cb7c8-40f0-835f-93ba-f44decc1f56e,7696,XBt,RealisedPNL,444987,0,Completed,XBTUSD,f3f04d8e-10f3-a8cc-2d97-2dc1d2cee7fe,,2018-12-05T12:00:00.000Z,262725460,2018-12-05T12:00:00.261Z
f16d5f43-5350-5358-22ea-0c10af8cbf86,7696,XBt,RealisedPNL,439485,0,Completed,XBTUSD,bdd34f5a-1ce4-acd7-e72a-7d68d7d0eea4,,2018-12-04T12:00:00.000Z,262280473,2018-12-04T12:00:00.274Z
d0456f57-a9f5-48ba-fc0d-da18398a7f3a,7696,XBt,RealisedPNL,419858,0,Completed,XBTUSD,8ddf3a49-9faa-910a-1609-c80ebd09fe95,,2018-12-03T12:00:00.000Z,261840988,2018-12-03T12:00:00.205Z
2ca27911-9abd-57a6-aa88-8a3333656f21,7696,XBt,RealisedPNL,408331,0,Completed,XBTUSD,3b1c6a15-bb0e-2179-31c4-9d4a5bb9b92e,,2018-12-02T12:00:00.000Z,261421130,2018-12-02T12:00:00.337Z
f9970a35-bda8-b6a1-cd92-91d1681cb1df,7696,XBt,RealisedPNL,429633,0,Completed,XBTUSD,f9493b15-b340-1ef5-413e-4775154c6494,,2018-12-01T12:00:00.000Z,261012799,2018-12-01T12:00:00.277Z
d8e5e3f1-62fa-7b0c-c049-e6d6c5d0608b,7696,XBt,RealisedPNL,604071,0,Completed,XBTUSD,44e0dc68-97c5-7522-c846-242dc50434d7,,2018-11-30T12:00:00.000Z,260583166,2018-11-30T12:00:00.263Z
0d63c658-1ea4-5232-9498-b6f553530844,7696,XBt,RealisedPNL,-13974,0,Completed,ETHUSD,44e0dc68-97c5-7522-c846-242dc50434d7,,2018-11-30T12:00:00.000Z,259979095,2018-11-30T12:00:00.263Z
eda2d849-61bb-e511-0f41-955027a235e7,7696,XBt,RealisedPNL,296888,0,Completed,XBTUSD,8bda6497-5685-add0-e66a-5b3c7f700a67,,2018-11-29T12:00:00.000Z,259993069,2018-11-29T12:00:00.301Z
b8d40fe8-1acd-5e28-8c6e-76f1150c2b80,7696,XBt,RealisedPNL,-210,0,Completed,ETHUSD,8bda6497-5685-add0-e66a-5b3c7f700a67,,2018-11-29T12:00:00.000Z,259696181,2018-11-29T12:00:00.301Z
e2808ee4-6857-49ca-e6e3-de88e1332a75,7696,XBt,RealisedPNL,334884,0,Completed,XBTUSD,1fe08c0f-c99a-788c-5e92-fd25e39b0234,,2018-11-28T12:00:00.000Z,259696391,2018-11-28T12:00:00.333Z
6f504c19-efb6-a268-c79a-b7186efa154e,7696,XBt,RealisedPNL,2337,0,Completed,ETHUSD,1fe08c0f-c99a-788c-5e92-fd25e39b0234,,2018-11-28T12:00:00.000Z,259361507,2018-11-28T12:00:00.333Z
5492c3ce-44d3-56f7-70c5-e846068dae20,7696,XBt,RealisedPNL,301194,0,Completed,XBTUSD,f5bde8e1-b473-993f-6c94-30a5870990e4,,2018-11-27T12:00:00.000Z,259359170,2018-11-27T12:00:00.233Z
d4992e8e-782c-e97a-c0df-c5c9367822d7,7696,XBt,RealisedPNL,-78,0,Completed,ETHUSD,f5bde8e1-b473-993f-6c94-30a5870990e4,,2018-11-27T12:00:00.000Z,259057976,2018-11-27T12:00:00.233Z
ee0c9740-2235-fbe1-2dea-6204a78aac6b,7696,XBt,RealisedPNL,1422536,0,Completed,XBTUSD,6b3b1926-0d02-7cba-6242-5952308bb33f,,2018-11-26T12:00:00.000Z,259058054,2018-11-26T12:00:00.264Z
bb9206f6-3b3c-9e8a-bd1c-96459bb9b838,7696,XBt,RealisedPNL,-250699,0,Completed,XBTUSD,1a94f586-688a-5b45-2dd9-74ee1352b334,,2018-11-25T12:00:00.000Z,257635518,2018-11-25T12:00:00.283Z
28a737d2-8639-235e-c9cb-f0c29cb48a29,7696,XBt,RealisedPNL,-234292,0,Completed,XBTUSD,3c6cf193-824b-d6b2-5a42-3a0ddd6cac71,,2018-11-24T12:00:00.000Z,257886217,2018-11-24T12:00:00.256Z
af59dc6b-f608-43ff-8229-529f1687a008,7696,XBt,RealisedPNL,-120936,0,Completed,XBTUSD,6e082640-85fa-64cf-e0a9-3374ce9ae8cd,,2018-11-23T12:00:00.000Z,258120509,2018-11-23T12:00:00.261Z
c35422d2-340a-a3c6-887f-649f4d0d1110,7696,XBt,RealisedPNL,5356,0,Completed,XBTUSD,4f0c55bb-2699-a932-4143-fe4060f4c2a4,,2018-11-22T12:00:00.000Z,258241445,2018-11-22T12:00:00.212Z
06b62d06-d0c9-9b0d-fe22-0fc8ce9ad385,7696,XBt,RealisedPNL,-372,0,Completed,XBTUSD,6cd43080-02eb-91b5-f736-c850bcf77408,,2018-11-20T12:00:00.000Z,258236089,2018-11-20T12:00:00.323Z
ee129a8a-1d3f-7486-43ac-c3b34538d3b6,7696,XBt,RealisedPNL,63563,0,Completed,XBTUSD,5d3bebc6-4b20-b42d-bea9-0a6f3e08e244,,2018-11-19T12:00:00.000Z,258236461,2018-11-19T12:00:00.282Z
7fc842a4-119d-f097-61f2-18ae736f8d3d,7696,XBt,RealisedPNL,-120064,0,Completed,XBTUSD,582a197d-5991-32d6-71cd-13413b419fd9,,2018-11-17T12:00:00.000Z,258172898,2018-11-17T12:00:00.277Z
c179d097-0add-f779-90f0-f24bb5c90f8b,7696,XBt,RealisedPNL,16209,0,Completed,XBTUSD,1d64e996-ec42-2a3d-3f8d-5b0b1170d4fa,,2018-11-16T12:00:00.000Z,258292962,2018-11-16T12:00:00.282Z
d24c768d-188c-3671-996c-f21e4aec1f11,7696,XBt,RealisedPNL,-2004,0,Completed,XBTUSD,9fbc8db7-b3a1-85d1-bead-1727c96ba06e,,2018-11-15T12:00:00.000Z,258276753,2018-11-15T12:00:00.347Z
f87fe766-9a0e-6541-46cf-79dce2ed84a2,7696,XBt,RealisedPNL,-3662,0,Completed,XBTUSD,8eda0f7c-8163-dfbe-579a-72ff84206d51,,2018-11-14T12:00:00.000Z,258278757,2018-11-14T12:00:00.310Z
b51720bc-6a1a-a233-a343-91b731bc99f7,7696,XBt,RealisedPNL,-52943,0,Completed,XBTUSD,0e095ac7-2fe3-4eb9-2cdb-725125c44af0,,2018-11-13T12:00:00.000Z,258282419,2018-11-13T12:00:00.237Z
110d5d7b-e8ef-ab04-166c-ba5fc40cece5,7696,XBt,RealisedPNL,-1046,0,Completed,XBTUSD,53f9c149-01ba-ece4-caaa-66ce36cef888,,2018-11-12T12:00:00.000Z,258335362,2018-11-12T12:00:00.211Z
1c61a0ba-9425-e5cd-ec50-33ac12dc10c5,7696,XBt,RealisedPNL,2348,0,Completed,XBTUSD,ee942bfb-9bd5-726a-574b-7156db8f6540,,2018-11-11T12:00:00.000Z,258336408,2018-11-11T12:00:00.267Z
de9825ef-dc9d-b44f-bca6-bb771baea978,7696,XBt,RealisedPNL,-16720,0,Completed,XBTUSD,bb7344db-fd5f-e13a-d94c-f9312d7458b0,,2018-11-10T12:00:00.000Z,258334060,2018-11-10T12:00:00.210Z
e15f4975-43a8-e144-4501-7212c7719dd7,7696,XBt,RealisedPNL,7036,0,Completed,XBTUSD,a4f221f0-3de9-647d-b4d3-79354fa05d45,,2018-11-09T12:00:00.000Z,258350780,2018-11-09T12:00:00.218Z
a3107cff-7ee6-b7ff-f17f-2d629e20b524,7696,XBt,RealisedPNL,-8926,0,Completed,XBTUSD,3ac66246-70ea-cc7e-7119-60e9b419e6ff,,2018-11-08T12:00:00.000Z,258343744,2018-11-08T12:00:00.217Z
43f88c43-9bea-af9c-9ff6-e1d91fccab45,7696,XBt,RealisedPNL,-1977,0,Completed,XBTUSD,ba501f3c-d325-1776-1c9a-598123db1e60,,2018-11-07T12:00:00.000Z,258352670,2018-11-07T12:00:00.210Z
6bf4515b-fad8-3831-416d-7be3e8253699,7696,XBt,RealisedPNL,-305,0,Completed,XBTUSD,86f95585-c5ca-3cd1-1880-d2dc31cf2928,,2018-11-06T12:00:00.000Z,258354647,2018-11-06T12:00:00.238Z
e0408c77-b19b-761b-211f-d6e613eb431d,7696,XBt,RealisedPNL,-100,0,Completed,XBTUSD,2dbfdf00-ff11-ae5b-328e-dc7a9120f357,,2018-11-05T12:00:00.000Z,258354952,2018-11-05T12:00:00.240Z
5de96c82-cf7d-57aa-c82a-41170e31c079,7696,XBt,RealisedPNL,22,0,Completed,XBTUSD,421c78cf-21f8-b5b0-1298-45bfc6b5fba6,,2018-11-04T12:00:00.000Z,258355052,2018-11-04T12:00:00.238Z
01457286-fcfa-dabc-b369-4161df3e31de,7696,XBt,RealisedPNL,27,0,Completed,XBTUSD,5105b4b6-c9ea-834c-4556-cb780c146ce6,,2018-11-03T12:00:00.000Z,258355030,2018-11-03T12:00:00.236Z
710f6404-e9c0-4885-0d03-022d0cb701e1,7696,XBt,RealisedPNL,36,0,Completed,XBTUSD,5479c929-d2ff-537c-f27e-9dc5e31d86a3,,2018-11-02T12:00:00.000Z,258355003,2018-11-02T12:00:00.235Z
0578e16c-8ce0-e967-b694-fceb8c7af9c4,7696,XBt,RealisedPNL,30,0,Completed,XBTUSD,05863e3a-197b-374d-9f72-6abc7f6d0813,,2018-11-01T12:00:00.000Z,258354967,2018-11-01T12:00:00.246Z
13be1093-d9a2-5d66-046e-1a9ffaa5681b,7696,XBt,RealisedPNL,8088,0,Completed,XBTUSD,a7417338-5354-fc3d-f81d-344ca9444ba4,,2018-10-31T12:00:00.000Z,258354937,2018-10-31T12:00:00.277Z
f752c1c3-24b4-882c-093a-35324acadc80,7696,XBt,RealisedPNL,6738,0,Completed,XBTUSD,99d6c8a4-18f8-d77d-7052-23ea24a757ff,,2018-10-30T12:00:00.000Z,258346849,2018-10-30T12:00:00.197Z
57785a6e-ea8d-dc60-2d76-7cb80a637fa1,7696,XBt,RealisedPNL,5419,0,Completed,XBTUSD,3de1f0c6-5528-dfbc-6d16-af5724db52d1,,2018-10-29T12:00:00.000Z,258340111,2018-10-29T12:00:00.232Z
c45df0cd-3a0d-b5e8-e117-68b6f2ffedd3,7696,XBt,RealisedPNL,507,0,Completed,XBTUSD,073dc24d-9818-727d-4350-9fbfb16dfa4e,,2018-10-28T12:00:00.000Z,258334692,2018-10-28T12:00:00.271Z
a6f34b24-64c1-849a-2b0a-9db48e248ebb,7696,XBt,RealisedPNL,812,0,Completed,XBTUSD,46cab3f4-4b87-0c2b-fe00-f5f189e8c525,,2018-10-27T12:00:00.000Z,258334185,2018-10-27T12:00:00.259Z
1c7d57bb-22f4-88d2-fcb8-7543cdf9c0f1,7696,XBt,RealisedPNL,4957,0,Completed,XBTUSD,3c2d096d-d3ae-6efd-5c60-9f0fc4742d67,,2018-10-26T12:00:00.000Z,258333373,2018-10-26T12:00:00.255Z
f614ae9a-9a0f-d399-e201-cc1ee96672b8,7696,XBt,RealisedPNL,-1336,0,Completed,XBTUSD,a1f13bec-ce8b-9c9b-bd46-3e1876ef3629,,2018-10-25T12:00:00.000Z,258328416,2018-10-25T12:00:00.232Z
b9c59565-d97e-66c9-1e30-23343760f783,7696,XBt,RealisedPNL,5987,0,Completed,XBTUSD,84b15736-f5cf-bd62-512b-2cee6ee8bea7,,2018-10-24T12:00:00.000Z,258329752,2018-10-24T12:00:00.274Z
b954d17c-122b-effa-e578-6fa26471149d,7696,XBt,RealisedPNL,-4892,0,Completed,XBTUSD,9038d931-ee3d-53cc-e97d-299ad21f13be,,2018-10-23T12:00:00.000Z,258323765,2018-10-23T12:00:00.243Z
85581a6e-2016-f7fe-50c2-6ac1139f4d84,7696,XBt,RealisedPNL,-12514,0,Completed,XBTUSD,464d2017-285c-26cb-b9d1-a1bf1f39a19b,,2018-10-22T12:00:00.000Z,258328657,2018-10-22T12:00:00.329Z
e5a56132-32b3-34bc-30d9-bf8d373081fd,7696,XBt,RealisedPNL,-345,0,Completed,XBTUSD,8139c152-ca53-3b8c-eb7a-e1e273c263ed,,2018-10-21T12:00:00.000Z,258341171,2018-10-21T12:00:00.232Z
c246ec74-a931-1325-3fce-c02653bbaaf9,7696,XBt,RealisedPNL,2205,0,Completed,XBTUSD,e29b4c9e-89b3-cc05-a0bb-f8794f93fd89,,2018-10-20T12:00:00.000Z,258341516,2018-10-20T12:00:00.306Z
ec60c745-c8d1-59c3-1e59-dd56fe46d75e,7696,XBt,RealisedPNL,-717,0,Completed,XBTUSD,d2d40e21-5530-e493-0493-29fb86163d67,,2018-10-19T12:00:00.000Z,258339311,2018-10-19T12:00:00.292Z
41bf3b15-89cc-54fe-5795-6d9c5dad2c08,7696,XBt,RealisedPNL,-1758,0,Completed,XBTUSD,55ecca49-6644-104e-c984-302e9987b91d,,2018-10-18T12:00:00.000Z,258340028,2018-10-18T12:00:00.304Z
86b1b709-1824-ca66-4208-55ce8aaad8aa,7696,XBt,RealisedPNL,-1730,0,Completed,XBTUSD,0a28927a-5484-a08a-3f5d-c420088297fe,,2018-10-17T12:00:00.000Z,258341786,2018-10-17T12:00:00.240Z
d16fd455-d422-70f2-f6f8-5aa0701aaced,7696,XBt,RealisedPNL,-2256,0,Completed,XBTUSD,7b85a1bb-e279-2fd1-4907-1ea64a5e4e78,,2018-10-15T12:00:00.000Z,258343516,2018-10-15T12:00:00.327Z
d77dbeae-c056-6716-90be-d282d304c5d4,7696,XBt,RealisedPNL,-2613,0,Completed,XBTUSD,fd4a4b16-a8a8-a8e3-18b9-7becd295deae,,2018-10-12T12:00:00.000Z,258345772,2018-10-12T12:00:00.277Z
10d1b2d8-57c0-2d62-9b1e-b20e4427645e,7696,XBt,RealisedPNL,-215,0,Completed,XBTUSD,8a1143e1-ba55-cc96-f1aa-be18db68ff5a,,2018-10-11T12:00:00.000Z,258348385,2018-10-11T12:00:00.284Z
33f2555b-48c7-8ea9-0539-c39e4c66a02d,7696,XBt,RealisedPNL,-5628,0,Completed,XBTUSD,1b627b8c-e519-ad50-82d0-34b6bcbbd628,,2018-10-10T12:00:00.000Z,258348600,2018-10-10T12:00:00.274Z
11e81a92-f52c-a6a0-4d4a-809669521f15,7696,XBt,RealisedPNL,-1767,0,Completed,XBTUSD,ae58cb8b-8076-2a99-5b20-15c1fc1e0358,,2018-10-09T12:00:00.000Z,258354228,2018-10-09T12:00:00.302Z
5224cd42-1fe1-20e0-a9dd-ce12a4b8ec14,7696,XBt,RealisedPNL,-9193,0,Completed,XBTUSD,196af395-113f-aa4e-7478-5038926d3045,,2018-10-08T12:00:00.000Z,258355995,2018-10-08T12:00:00.265Z
122ce8bb-6de4-04ee-2a3c-a349dd871f6a,7696,XBt,RealisedPNL,17,0,Completed,XBTUSD,cb099ec9-eeaa-7e00-1081-6a85f2e3c158,,2018-10-07T12:00:00.000Z,258365188,2018-10-07T12:00:00.292Z
8db16735-c411-c860-0456-285021fe0097,7696,XBt,RealisedPNL,-2303,0,Completed,XBTUSD,1403ec4a-f58d-7396-685b-6e8f7d27fc08,,2018-10-06T12:00:00.000Z,258365171,2018-10-06T12:00:00.249Z
ddf6bd92-dcb0-2998-8db0-97cba3eac4c6,7696,XBt,RealisedPNL,-38022,0,Completed,XBTUSD,605598ec-8e06-1cc1-d3f7-f279bc253191,,2018-10-05T12:00:00.000Z,258367474,2018-10-05T12:00:00.240Z
fcb1b888-599b-b1bb-b212-b8d84bae58cd,7696,XBt,RealisedPNL,-91698,0,Completed,XBTUSD,fb5d4a97-1d2a-9601-e030-de5b9191f38e,,2018-10-04T12:00:00.000Z,258405496,2018-10-04T12:00:00.244Z
656cb0fa-16a6-97f9-a508-58dc2effe36c,7696,XBt,RealisedPNL,320938,0,Completed,XBTUSD,a1b6548a-1c48-b721-e962-17129eb2746e,,2018-10-03T12:00:00.000Z,258497194,2018-10-03T12:00:00.276Z
8fa522cd-ffe6-875f-2817-1692f26be980,7696,XBt,RealisedPNL,-84940,0,Completed,XBTUSD,58935f7b-7833-e872-f80d-c0e6a33b91e5,,2018-10-02T12:00:00.000Z,258176256,2018-10-02T12:00:00.253Z
3d3f2948-16ab-f5b8-3e8c-31d55df66e69,7696,XBt,RealisedPNL,-32289,0,Completed,XBTUSD,fdabab14-de07-c4f6-9d58-0c8239a11fa2,,2018-09-29T12:00:00.000Z,258261196,2018-09-29T12:00:00.244Z
c101c4ca-216b-6deb-cb80-1652dcded48f,7696,XBt,RealisedPNL,-186114,0,Completed,XBTUSD,340738f7-fdb1-011d-0acf-de0002a06b4b,,2018-09-28T12:00:00.000Z,258293485,2018-09-28T12:00:00.334Z
7952a775-2420-bdb9-e7f9-e3c0034be135,7696,XBt,RealisedPNL,148,0,Completed,XBTUSD,58dda69a-aa73-fb59-ebdd-306f34bb72cd,,2018-09-27T12:00:00.000Z,258479599,2018-09-27T12:00:00.275Z
c1f31439-9f05-cd16-a37e-48ca7b266484,7696,XBt,RealisedPNL,-214652,0,Completed,XBTUSD,a38a1972-fe15-a616-7479-73ea4ab2f1e5,,2018-09-26T12:00:00.000Z,258479451,2018-09-26T12:00:00.269Z
6f78723d-141f-06b9-544f-1f66c9ca16bb,7696,XBt,RealisedPNL,-18267,0,Completed,XBTUSD,dbbe4194-4ea9-886e-cb70-6929f0ef6b4a,,2018-09-25T12:00:00.000Z,258694103,2018-09-25T12:00:00.253Z
11cceec4-aa99-5ee7-2cb9-a434f40fc859,7696,XBt,RealisedPNL,-118649,0,Completed,XBTUSD,22463f75-eb45-acf7-b32e-af97249d7d32,,2018-09-24T12:00:00.000Z,258712370,2018-09-24T12:00:00.254Z
a7ebfac7-0b83-5ad3-2936-b8c0ce46b102,7696,XBt,RealisedPNL,-13649,0,Completed,XBTUSD,924fe498-b5ef-aa21-6a7c-f9c4f61e1eed,,2018-09-23T12:00:00.000Z,258831019,2018-09-23T12:00:00.282Z
b5db492d-0a3f-521c-78ab-2ed7d076d731,7696,XBt,RealisedPNL,-17220,0,Completed,XBTUSD,9a9eb47e-2fcb-3889-3f84-710f7ec5c132,,2018-09-22T12:00:00.000Z,258844668,2018-09-22T12:00:00.267Z
9897177b-db1d-078a-1360-4ed22340da6f,7696,XBt,RealisedPNL,-12796,0,Completed,XBTUSD,5ccd15f3-7e83-a5af-c7c3-cc634dbcc111,,2018-09-21T12:00:00.000Z,258861888,2018-09-21T12:00:00.288Z
ea163fb3-8943-2063-1b97-3d0dfcacf0f5,7696,XBt,RealisedPNL,19446,0,Completed,XBTUSD,f31dd356-3300-829a-2a0a-4cb02ea95466,,2018-09-20T12:00:00.000Z,258874684,2018-09-20T12:00:00.267Z
c8c605d5-0be6-ad30-081c-1fbfaf312cef,7696,XBt,RealisedPNL,42965,0,Completed,XBTUSD,97bbdd36-0521-9e4f-16e3-c1a6f1031222,,2018-09-19T12:00:00.000Z,258855238,2018-09-19T12:00:00.269Z
a331bb5f-0826-98e9-2220-58851261ddb4,7696,XBt,RealisedPNL,3058,0,Completed,XBTUSD,b54f7987-ee9e-50e2-44d4-3b1fe618dd7e,,2018-09-18T12:00:00.000Z,258812273,2018-09-18T12:00:00.290Z
dddc808f-34b7-833c-e9b4-aed22171806b,7696,XBt,RealisedPNL,-29467,0,Completed,XBTUSD,5c420b00-931b-ef6b-2ae2-0db5b23037cf,,2018-09-17T12:00:00.000Z,258809215,2018-09-17T12:00:00.281Z
bec8cd4d-81b8-cc49-7225-8f304d124884,7696,XBt,RealisedPNL,-42887,0,Completed,XBTUSD,64552cb4-e447-c3e5-b4e6-9d52fe6301b4,,2018-09-16T12:00:00.000Z,258838682,2018-09-16T12:00:00.298Z
5c331ba7-fa39-a4da-3b88-874b5cc4b565,7696,XBt,RealisedPNL,-8983,0,Completed,XBTUSD,165314bd-c911-4a04-a29b-03cd82f3a6c8,,2018-09-15T12:00:00.000Z,258881569,2018-09-15T12:00:00.257Z
d83b1cdf-87e6-8b79-9f04-de87012b9ede,7696,XBt,RealisedPNL,251145,0,Completed,XBTUSD,c4cbfbdb-9767-15c4-27e1-b4b8a3227070,,2018-09-14T12:00:00.000Z,258890552,2018-09-14T12:00:00.276Z
e72d9267-00ad-28c3-9b1c-d4c5f4810ad2,7696,XBt,RealisedPNL,-5364,0,Completed,XBTUSD,c5612e64-52b1-b90f-7af0-64bbd3b2e224,,2018-09-13T12:00:00.000Z,258639407,2018-09-13T12:00:00.264Z
14aabe71-63da-efbf-a67f-3069db83f590,7696,XBt,RealisedPNL,77027,0,Completed,XBTUSD,ad33ad49-7294-73a7-d19d-ba8715a0bfa9,,2018-09-12T12:00:00.000Z,258644771,2018-09-12T12:00:00.344Z
ef8f20fb-d568-9755-1828-98984b34a046,7696,XBt,RealisedPNL,-143710,0,Completed,XBTUSD,db052aca-9fdb-ec9d-4b1d-d6f7c2e5db5f,,2018-09-11T12:00:00.000Z,258567744,2018-09-11T12:00:00.274Z
370cb8d7-4810-236f-dbc9-0bbfe8fa34ca,7696,XBt,RealisedPNL,-8128,0,Completed,XBTUSD,fe115e83-7917-49f3-c170-0b23c208c018,,2018-09-10T12:00:00.000Z,258711454,2018-09-10T12:00:00.208Z
a49c6bc3-e7db-02bd-350d-0e14f6da5d84,7696,XBt,RealisedPNL,-25490,0,Completed,XBTUSD,4c13d7fc-5bf6-85d8-bce3-2d2d69d69951,,2018-09-09T12:00:00.000Z,258719582,2018-09-09T12:00:00.222Z
59245242-86ef-0fd1-db87-90543998fe24,7696,XBt,RealisedPNL,-28082,0,Completed,XBTUSD,11c9a638-44ab-a92a-7954-46afdaaac65b,,2018-09-08T12:00:00.000Z,258745072,2018-09-08T12:00:00.223Z
ed0aca91-6f39-4e97-b04f-3b41c6168d46,7696,XBt,RealisedPNL,2216,0,Completed,XBTUSD,99fe6375-73aa-751f-ddfb-35f9e0517b18,,2018-09-07T12:00:00.000Z,258773154,2018-09-07T12:00:00.242Z
01215d66-bccc-2860-d06b-262a3bc9d4df,7696,XBt,RealisedPNL,15598,0,Completed,XBTUSD,0c1943df-2122-61c3-31b7-ba30afae810a,,2018-09-06T12:00:00.000Z,258770938,2018-09-06T12:00:00.229Z
e85a1ede-4409-da1c-3896-b6f20b44ecfc,7696,XBt,RealisedPNL,17227,0,Completed,XBTUSD,87a4e319-af5f-af54-e0ed-613a47b08eb1,,2018-09-05T12:00:00.000Z,258755340,2018-09-05T12:00:00.250Z
7ea2643d-cd7e-c277-b1da-336123e079d1,7696,XBt,RealisedPNL,4254,0,Completed,XBTUSD,ce304d5c-d997-0633-37d7-8781e474272d,,2018-09-04T12:00:00.000Z,258738113,2018-09-04T12:00:00.258Z
3037966c-0a8d-9070-48de-51683c4db898,7696,XBt,RealisedPNL,3760,0,Completed,XBTUSD,78fce32e-b2df-5000-f7d8-433ba094a8fe,,2018-09-03T12:00:00.000Z,258733859,2018-09-03T12:00:00.200Z
a4ef25a2-21de-31b1-21b2-909852ed04f7,7696,XBt,RealisedPNL,1875,0,Completed,XBTUSD,cb5f7006-448d-2de7-8fd7-16257c9d6e18,,2018-09-02T12:00:00.000Z,258730099,2018-09-02T12:00:00.192Z
6148bc00-d932-a379-b14d-459447bbeae4,7696,XBt,RealisedPNL,8345,0,Completed,XBTUSD,99ba12f2-a052-ca7e-40c5-6729b13ac532,,2018-09-01T12:00:00.000Z,258728224,2018-09-01T12:00:00.219Z
14aa4e8a-82b0-ded7-56e3-12b85abf2719,7696,XBt,RealisedPNL,27686,0,Completed,XBTUSD,f84bf784-c395-898a-cd33-322d3267a8f7,,2018-08-31T12:00:00.000Z,258719879,2018-08-31T12:00:00.208Z
2a834232-628e-87d1-a66e-b8fcfb1ea99d,7696,XBt,RealisedPNL,-1294,0,Completed,XBTUSD,192e14ad-6c4b-8dae-6926-774987cb4674,,2018-08-30T12:00:00.000Z,258692193,2018-08-30T12:00:00.235Z
549c9b56-54d7-5624-2f6d-2178d43308ea,7696,XBt,RealisedPNL,-16623,0,Completed,XBTUSD,a35ad316-aa1f-a059-057a-80cf42880e4e,,2018-08-29T12:00:00.000Z,258693487,2018-08-29T12:00:00.236Z
723d45f4-6e84-1b30-4087-de745fe831ea,7696,XBt,RealisedPNL,33213,0,Completed,XBTUSD,7071f25d-5e2e-ec1a-8850-cbff3c677229,,2018-08-28T12:00:00.000Z,258710110,2018-08-28T12:00:00.199Z
f323a5d7-f8cb-c87e-5f97-adf9b57f79ff,7696,XBt,RealisedPNL,26086,0,Completed,XBTUSD,ec4d3ce8-451b-f430-f778-15d7ad5e3a23,,2018-08-27T12:00:00.000Z,258676897,2018-08-27T12:00:00.230Z
4e461a1c-cf53-548a-ffdd-4e0cb430063a,7696,XBt,RealisedPNL,33698,0,Completed,XBTUSD,f4758b06-52ac-6b12-0566-94c1e46e17b0,,2018-08-26T12:00:00.000Z,258650811,2018-08-26T12:00:00.257Z
83786d15-779f-3378-4980-01099c383785,7696,XBt,RealisedPNL,18921,0,Completed,XBTUSD,39f1bbd6-230f-df97-318f-9833782904ff,,2018-08-25T12:00:00.000Z,258617113,2018-08-25T12:00:00.223Z
3d2c817d-6a86-8624-4609-c2a1cb2e2c8d,7696,XBt,RealisedPNL,24695,0,Completed,XBTUSD,7492bec3-25b5-ab5f-c9e1-8edb90b63523,,2018-08-24T12:00:00.000Z,258598192,2018-08-24T12:00:00.225Z
6d39c840-bcfe-461d-8512-4186876d2cb1,7696,XBt,RealisedPNL,-744,0,Completed,XBTUSD,491621dd-4829-34b8-9f9c-114a0677e258,,2018-08-16T12:00:00.000Z,258573497,2018-08-16T12:00:00.206Z
5cb519e3-c3f4-f643-bf00-01c0eab8bf76,7696,XBt,RealisedPNL,-1109818,0,Completed,XBTUSD,8b9c469f-7a0b-47e4-1f1d-f7ead79614d0,,2018-08-14T12:00:00.000Z,258574241,2018-08-14T12:00:00.171Z
65903399-27fb-ebd0-d84d-ce367ba858d0,7696,XBt,RealisedPNL,-22524,0,Completed,XBTUSD,501c8a17-95c4-c555-5634-140bde1496fb,,2018-08-13T12:00:00.000Z,259684059,2018-08-13T12:00:00.176Z
f25b5ee6-a906-3d86-1164-f8e024ed7111,7696,XBt,RealisedPNL,267090,0,Completed,XBTUSD,c0f3c870-96cd-1e28-d285-ed931776d612,,2018-08-12T12:00:00.000Z,259706583,2018-08-12T12:00:00.188Z
8a36e60e-e306-8db6-eb47-3c3854bd9637,7696,XBt,RealisedPNL,313533,0,Completed,XBTUSD,7a3b1fbc-3534-e5c5-e6de-0b65369a2511,,2018-08-11T12:00:00.000Z,259439493,2018-08-11T12:00:00.175Z
7ab04e4d-df90-c707-2870-3b4c4a249678,7696,XBt,RealisedPNL,533074,0,Completed,XBTUSD,600833e9-9a01-ac6a-6d9e-18048050056a,,2018-08-10T12:00:00.000Z,259125960,2018-08-10T12:00:00.545Z
e19aafd1-151a-a17a-1a0f-51524adb6698,7696,XBt,RealisedPNL,-342201,0,Completed,XBTUSD,d66ad7e7-0910-0a5c-2896-e2e2e7e09d62,,2018-08-09T12:00:00.000Z,258592886,2018-08-09T12:00:00.197Z
c4344c46-da49-c20d-9ebe-3aeca8d98c8b,7696,XBt,RealisedPNL,-656402,0,Completed,XBTUSD,d0721732-4df7-237e-9875-9c886c93230f,,2018-08-08T12:00:00.000Z,258935087,2018-08-08T12:00:00.324Z
54d69965-7835-743e-5ec0-e4160fe0bfc6,7696,XBt,RealisedPNL,-449317,0,Completed,XBTUSD,a5c99f83-cc4d-bfa0-224f-96a8fe1b33e0,,2018-08-07T12:00:00.000Z,259591489,2018-08-07T12:00:00.189Z
e8a81f15-d759-4491-940b-cee0ed2e6f66,7696,XBt,RealisedPNL,-41289,0,Completed,XBTUSD,5b6ce5d1-0fc1-361f-728c-8da3a6447076,,2018-08-06T12:00:00.000Z,260040806,2018-08-06T12:00:00.188Z
bbf07249-cc86-32c8-de29-f06566ee5e40,7696,XBt,RealisedPNL,-14597,0,Completed,XBTUSD,4f9880fd-5753-7852-05ff-38e273267d77,,2018-08-05T12:00:00.000Z,260082095,2018-08-05T12:00:00.189Z
d82ccbbf-c94a-5b14-2161-84f5da749ffe,7696,XBt,RealisedPNL,-22930,0,Completed,XBTUSD,d45c16a1-e923-36cf-4f08-04b88d3c872e,,2018-08-04T12:00:00.000Z,260096692,2018-08-04T12:00:00.185Z
bad2462c-5cbf-8bd0-a02e-fcd18f86ff55,7696,XBt,RealisedPNL,18200,0,Completed,XBTUSD,73320a39-845a-9b45-1b6f-c0dc4c3303b2,,2018-08-03T12:00:00.000Z,260119622,2018-08-03T12:00:00.178Z
c7a180b6-3902-3867-3f74-eb3c4c8e9d66,7696,XBt,RealisedPNL,-53981,0,Completed,XBTUSD,c52634c7-e504-5f31-3630-562038d620bf,,2018-08-02T12:00:00.000Z,260101422,2018-08-02T12:00:00.249Z
5aaaa1fb-b1ed-4004-19dc-324c18dfe862,7696,XBt,RealisedPNL,-71675,0,Completed,XBTUSD,15dd593d-6afd-a088-d869-3b2c1a6945a1,,2018-08-01T12:00:00.000Z,260155403,2018-08-01T12:00:00.262Z
c4de803b-cc66-d7e2-ef24-bf1bec004d51,7696,XBt,RealisedPNL,-59939,0,Completed,XBTUSD,3e72fb58-beb2-aaf1-c0ee-ebf0174db588,,2018-07-31T12:00:00.000Z,260227078,2018-07-31T12:00:00.255Z
944b8a8d-a528-f2f1-52e6-19acc970bc2e,7696,XBt,RealisedPNL,-22129,0,Completed,XBTUSD,62d210ba-e3bf-8971-b842-260a345ea2c9,,2018-07-30T12:00:00.000Z,260287017,2018-07-30T12:00:00.253Z
4278a02a-cbac-579a-77a2-ba55a57e5a20,7696,XBt,RealisedPNL,-24622,0,Completed,XBTUSD,af4f3944-efdd-5137-92ca-b5669476710f,,2018-07-29T12:00:00.000Z,260309146,2018-07-29T12:00:00.273Z
050f7773-d555-eeaf-b014-c04993aefea2,7696,XBt,RealisedPNL,-15522,0,Completed,XBTUSD,85955338-d21f-cdec-b186-da8f0d86fe25,,2018-07-28T12:00:00.000Z,260333768,2018-07-28T12:00:00.259Z
39a9c0d8-dda3-6b46-8ad1-288c21642124,7696,XBt,RealisedPNL,-1846,0,Completed,XBTUSD,0b8fa6f1-f0cc-adbe-49d2-450d19e5ddac,,2018-07-27T12:00:00.000Z,260349290,2018-07-27T12:00:00.231Z
5c317f4d-bbaf-e362-fe19-d26aa4c3ea27,7696,XBt,RealisedPNL,35,0,Completed,XBTUSD,0f758b59-65de-5c56-b63d-3f5ef5498e48,,2018-07-26T12:00:00.000Z,260351136,2018-07-26T12:00:00.262Z
838d3e6d-223a-a2ed-7e9d-11d557bb057a,7696,XBt,RealisedPNL,362425,0,Completed,XBTUSD,1ed771a5-15a0-a6ea-a5ff-69fb872d6eb2,,2018-07-25T12:00:00.000Z,260351101,2018-07-25T12:00:00.219Z
2d01004b-a6b4-7bda-32d8-c1f63d6d6740,7696,XBt,RealisedPNL,75628,0,Completed,XBTUSD,615ea883-5548-0ee2-7cf2-02e29dc25652,,2018-07-24T12:00:00.000Z,259988676,2018-07-24T12:00:00.174Z
e78a94d1-b4d7-d2a5-66c6-5b991e1fdd73,7696,XBt,RealisedPNL,364582,0,Completed,XBTUSD,91c84494-3c74-9c76-d6f1-9fb9cc361fd5,,2018-07-21T12:00:00.000Z,259913048,2018-07-21T12:00:00.197Z
47cfccf6-cb50-9d72-5efa-9ddd90070c76,7696,XBt,RealisedPNL,-35369,0,Completed,XBTUSD,bbe6d3bd-3a5d-8ad3-7f3d-aece4b0bb21c,,2018-07-20T12:00:00.000Z,259548466,2018-07-20T12:00:00.208Z
2ea4ab08-0eec-ee27-77c5-82450580d8b8,7696,XBt,RealisedPNL,41746,0,Completed,XBTUSD,683c1215-7393-5bee-8796-35ffaf1c3103,,2018-07-19T12:00:00.000Z,259583835,2018-07-19T12:00:00.205Z
0670e45f-15e0-a49f-54e3-5bf0cb3f601f,7696,XBt,RealisedPNL,10723,0,Completed,XBTUSD,7eb38e42-dbc3-4c74-bc47-b7988b08a9d4,,2018-07-18T12:00:00.000Z,259542089,2018-07-18T12:00:00.198Z
d73377a9-3c0f-888d-fd38-60ec3f013643,7696,XBt,RealisedPNL,-878861,0,Completed,XBTUSD,31ba1570-0dad-d9f8-33d5-3a6077c12aa4,,2018-07-17T12:00:00.000Z,259531366,2018-07-17T12:00:00.195Z
e76336b5-0b94-5f37-e060-308ca9aeec9e,7696,XBt,RealisedPNL,-119057,0,Completed,XBTUSD,e7ca730c-fb98-d0fa-2aa8-55e6243358d6,,2018-07-16T12:00:00.000Z,260410227,2018-07-16T12:00:00.196Z
e1ec4a14-e98c-ca13-dfff-4cc96316555b,7696,XBt,RealisedPNL,159348,0,Completed,XBTUSD,d26be7b7-d543-71e9-2d8e-16b7b1ceb5fb,,2018-07-15T12:00:00.000Z,260529284,2018-07-15T12:00:00.209Z
76212048-eaf6-31f8-502e-c884d19c0982,7696,XBt,RealisedPNL,82660,0,Completed,XBTUSD,42aa47ce-b778-e2c7-f3f1-0e90172f7f66,,2018-07-14T12:00:00.000Z,260369936,2018-07-14T12:00:00.154Z
f5a1b50d-4ac7-88f6-9baf-83a52c79cc1d,7696,XBt,RealisedPNL,6275,0,Completed,XBTUSD,6d9910ca-2504-9e3c-b493-ca2e63610cf3,,2018-07-13T12:00:00.000Z,260287276,2018-07-13T12:00:00.207Z
e9bf9899-30c1-60db-b5b3-04519fdb64f6,7696,XBt,RealisedPNL,729579,0,Completed,XBTUSD,293c89e6-f12f-56d6-d6f1-51cb0a24216d,,2018-07-12T12:00:00.000Z,260281001,2018-07-12T12:00:00.225Z
5b389a52-38b0-e0bb-fa70-783d86da3320,7696,XBt,RealisedPNL,-169829,0,Completed,XBTUSD,b494b618-28ea-8ad3-5745-8a7180b5eea8,,2018-07-11T12:00:00.000Z,259551422,2018-07-11T12:00:00.199Z
6b812f36-46d4-c0ae-6b9d-50cbbdad63c6,7696,XBt,RealisedPNL,33643,0,Completed,XBTUSD,cd0dc2b0-fd8f-79f1-da30-567eac077db9,,2018-07-10T12:00:00.000Z,259721251,2018-07-10T12:00:00.191Z
706ba3ac-d555-6acf-122e-dc1333693d5a,7696,XBt,RealisedPNL,-76511,0,Completed,XBTUSD,22467770-be63-cb92-a332-b4a45580a220,,2018-07-09T12:00:00.000Z,259687608,2018-07-09T12:00:00.222Z
5ccc7555-f418-fc66-61bc-912d2a6b917a,7696,XBt,RealisedPNL,1586,0,Completed,XBTUSD,863fd015-8caa-eb32-32a5-b11e777a5243,,2018-07-08T12:00:00.000Z,259764119,2018-07-08T12:00:00.224Z
d099f4cc-352c-a986-cf78-eebed466947b,7696,XBt,RealisedPNL,14548,0,Completed,XBTUSD,634aa201-cb87-ea32-de05-e682acae0e2d,,2018-07-07T12:00:00.000Z,259762533,2018-07-07T12:00:00.207Z
d2e216eb-048a-c438-8c77-010da8c96f05,7696,XBt,RealisedPNL,467,0,Completed,XBTUSD,2af04999-f9c4-1d14-c6e5-5de6f9277dd7,,2018-07-06T12:00:00.000Z,259747985,2018-07-06T12:00:00.201Z
5193471e-3b55-c98e-e6ec-85b1480318f0,7696,XBt,RealisedPNL,13157,0,Completed,XBTUSD,b2723364-8288-eecc-2054-23267e2ff5c7,,2018-07-05T12:00:00.000Z,259747518,2018-07-05T12:00:00.222Z
4a8123f8-41c2-6490-d29d-fd04faf239ad,7696,XBt,RealisedPNL,-3281,0,Completed,XBTUSD,6d1d9fb4-e518-ec96-a56d-af0c6668eaf8,,2018-07-04T12:00:00.000Z,259734361,2018-07-04T12:00:00.162Z
79139b22-cb44-36af-c906-ab50b527f9a8,7696,XBt,RealisedPNL,392390,0,Completed,XBTUSD,f601da09-ebe2-3eee-f92b-fc9c2312c0a9,,2018-07-03T12:00:00.000Z,259737642,2018-07-03T12:00:00.157Z
6af431f2-6d6f-9fe7-31e3-d5f8ea830562,7696,XBt,RealisedPNL,35493,0,Completed,XBTUSD,b7f3b8a4-a052-d99f-f0d4-ecfcb141f7d6,,2018-07-02T12:00:00.000Z,259345252,2018-07-02T12:00:00.156Z
3bd14f12-8ab3-2a3f-9710-8e9280aadf1f,7696,XBt,RealisedPNL,35090,0,Completed,XBTUSD,6d1591e5-73c2-eae6-d23b-79d70853e3f2,,2018-07-01T12:00:00.000Z,259309759,2018-07-01T12:00:00.170Z
8e8bb341-3db0-f3c8-64e7-ba40a7d7a59d,7696,XBt,RealisedPNL,-41251,0,Completed,XBTUSD,0ec670cf-52fb-a05e-052c-a4449764a59c,,2018-06-30T12:00:00.000Z,259274669,2018-06-30T12:00:00.181Z
e00fbb63-1370-6822-4c3c-ead488be6207,7696,XBt,RealisedPNL,8382,0,Completed,XBTUSD,5ff5d7ab-dfc2-b46d-1423-c39fc6a3dd74,,2018-06-29T12:00:00.000Z,259315920,2018-06-29T12:00:00.181Z
913453d1-382b-7b9d-f0df-873ddea63585,7696,XBt,RealisedPNL,43122,0,Completed,XBTUSD,b1cd4aae-b9bb-b88b-4e78-c930ef1f4261,,2018-06-28T12:00:00.000Z,259307538,2018-06-28T12:00:00.193Z
76313bce-eabf-3629-b502-7cbb468b1bbd,7696,XBt,RealisedPNL,2939229,0,Completed,XBTUSD,aae407b7-95fe-4164-5d8b-e815fc40b6b4,,2018-06-25T12:00:00.000Z,259264416,2018-06-25T12:00:00.216Z
f2560729-f37c-9234-d195-07c7a11986af,7696,XBt,RealisedPNL,-21627,0,Completed,XBTM18,aae407b7-95fe-4164-5d8b-e815fc40b6b4,,2018-06-25T12:00:00.000Z,256325187,2018-06-25T12:00:00.216Z
a5e0e6a0-1490-179b-f3bb-32e78255fe4a,7696,XBt,RealisedPNL,-603101,0,Completed,XBTUSD,f056b81f-8ddd-17b3-f0e1-5376d977119d,,2018-06-24T12:00:00.000Z,256346814,2018-06-24T12:00:00.204Z
f3fdfa15-88e2-46c7-3f40-1b28e88b7c13,7696,XBt,RealisedPNL,104729,0,Completed,XBTUSD,8d36834b-14d1-c014-3bdd-59addc7d3535,,2018-06-23T12:00:00.000Z,256949915,2018-06-23T12:00:00.219Z
719ad6c6-f15d-6a72-bb6b-a4fd3de6ce88,7696,XBt,RealisedPNL,-274105,0,Completed,XBTUSD,7405a305-5583-7a02-0f4a-38a7c2625d17,,2018-06-22T12:00:00.000Z,256845186,2018-06-22T12:00:00.207Z
f5d9992d-e451-913c-1d2b-32818e7dac3f,7696,XBt,RealisedPNL,447,0,Completed,XBTUSD,695aa372-4811-98eb-552f-02624f0db8d7,,2018-06-21T12:00:00.000Z,257119291,2018-06-21T12:00:00.163Z
22e0b279-757f-0d36-1f10-fbbfb2a6700c,7696,XBt,RealisedPNL,348568,0,Completed,XBTUSD,74093251-64f0-03f0-d879-084f8665ac71,,2018-06-20T12:00:00.000Z,257118844,2018-06-20T12:00:00.163Z
c949064c-ac41-fed0-04a2-10c349cb7477,7696,XBt,RealisedPNL,2887,0,Completed,XBTUSD,79bb2c26-8cd8-abde-3d27-ab998a2cbeb4,,2018-06-19T12:00:00.000Z,256770276,2018-06-19T12:00:00.217Z
02fb1882-ed32-fe24-01fd-91554c6457bd,7696,XBt,RealisedPNL,-434264,0,Completed,XBTUSD,fe82ae3c-e39a-84e1-ea9c-5ee1aa2fc4ce,,2018-06-18T12:00:00.000Z,256767389,2018-06-18T12:00:00.196Z
5df4d601-8608-9994-fe90-ca03b7c5ad81,7696,XBt,RealisedPNL,-1172,0,Completed,XBTM18,fe82ae3c-e39a-84e1-ea9c-5ee1aa2fc4ce,,2018-06-18T12:00:00.000Z,257201653,2018-06-18T12:00:00.196Z
2b4f81a2-80aa-2e6d-be5d-8903346ec8c0,7696,XBt,RealisedPNL,32168,0,Completed,XBTUSD,6121d5b9-851c-426f-bb50-e62a45641937,,2018-06-17T12:00:00.000Z,257202825,2018-06-17T12:00:00.195Z
66467406-d211-c625-f610-dae1c595b857,7696,XBt,RealisedPNL,65782,0,Completed,XBTUSD,5f8b58aa-e98b-6bac-1795-fa479d07cd86,,2018-06-16T12:00:00.000Z,257170657,2018-06-16T12:00:00.189Z
fb8552d3-6cae-e55b-8c2e-22f8a803c819,7696,XBt,RealisedPNL,31960,0,Completed,XBTUSD,520c14d2-6364-b5c2-5274-be2232e1c48d,,2018-06-15T12:00:00.000Z,257104875,2018-06-15T12:00:00.195Z
d8acb652-2a20-d9d7-99b8-a9c6a58e1305,7696,XBt,RealisedPNL,3481,0,Completed,XBTUSD,4ec580e0-2a15-5e30-514f-323520f5cb0c,,2018-06-14T12:00:00.000Z,257072915,2018-06-14T12:00:00.188Z
bf16c0dd-4574-f50d-cf39-94069fca94fa,7696,XBt,RealisedPNL,21370,0,Completed,XBTUSD,49541378-0761-5710-5653-6be786a91a24,,2018-06-13T12:00:00.000Z,257069434,2018-06-13T12:00:00.184Z
ca258022-d61c-268b-4191-0c863b326a09,7696,XBt,RealisedPNL,5799,0,Completed,XBTUSD,614520c0-a16c-de00-5e0b-6fa7365f041d,,2018-06-12T12:00:00.000Z,257048064,2018-06-12T12:00:00.162Z
7f28e991-ee6d-6033-7f79-af64e1cfc2d8,7696,XBt,RealisedPNL,-32361,0,Completed,XBTUSD,1984d496-c539-535e-d80f-20b55e13557f,,2018-06-11T12:00:00.000Z,257042265,2018-06-11T12:00:00.148Z
889aa741-42b4-f052-118b-7929d24c6a41,7696,XBt,RealisedPNL,-27211,0,Completed,XBTUSD,67f297e2-9c20-f5fd-541b-4e79358b4030,,2018-06-10T12:00:00.000Z,257074626,2018-06-10T12:00:00.141Z
8d5b903a-2040-1630-25e3-0f3a2c2b475b,7696,XBt,RealisedPNL,-19663,0,Completed,XBTUSD,4e2b76de-3e19-4ca0-45e3-a9fc7eeabd0b,,2018-06-09T12:00:00.000Z,257101837,2018-06-09T12:00:00.142Z
593c9965-c45c-8c16-d3a5-bc386a9dd411,7696,XBt,RealisedPNL,-5183,0,Completed,XBTUSD,0003edb8-f801-294b-536e-224c7a2c5884,,2018-06-08T12:00:00.000Z,257121500,2018-06-08T12:00:00.138Z
58a0240f-b65b-ecf9-ea98-564a50de416a,7696,XBt,RealisedPNL,16585,0,Completed,XBTUSD,5af27da1-3b6c-4119-0037-c246ba4dd133,,2018-06-07T12:00:00.000Z,257126683,2018-06-07T12:00:00.220Z
72990fa7-f848-a95f-a5c7-8eaa9a95340a,7696,XBt,RealisedPNL,-5617,0,Completed,XBTUSD,ec89b19a-5ed1-1d12-4147-2815d143a037,,2018-06-06T12:00:00.000Z,257110098,2018-06-06T12:00:00.211Z
9d65a948-35e2-c11e-784a-2656a153efc6,7696,XBt,RealisedPNL,10144,0,Completed,XBTUSD,3425c021-2fdc-aee3-e7b2-6755a94eae77,,2018-06-05T12:00:00.000Z,257115715,2018-06-05T12:00:00.191Z
bfc45fdd-a7f3-004c-3904-e0a8bc2abf6e,7696,XBt,RealisedPNL,-25445,0,Completed,XBTUSD,8bf60146-3c48-d2cf-773e-9f840723724a,,2018-06-04T12:00:00.000Z,257105571,2018-06-04T12:00:00.186Z
2e8e4324-203c-35b2-0db1-31fc93f29f64,7696,XBt,RealisedPNL,7535,0,Completed,XBTUSD,b9e4a09c-952e-b16b-628b-f3136b676b1b,,2018-06-03T12:00:00.000Z,257131016,2018-06-03T12:00:00.198Z
d86b7af1-50e5-73e8-9ea6-628f5b845272,7696,XBt,RealisedPNL,10236,0,Completed,XBTUSD,712025e5-6a11-381e-0976-3b66985d3f2f,,2018-06-02T12:00:00.000Z,257123481,2018-06-02T12:00:00.200Z
655e5089-db54-458a-5d80-c2d35ea29148,7696,XBt,RealisedPNL,13506,0,Completed,XBTUSD,a17a21c7-d38a-2fa2-9e35-9b65811b1038,,2018-06-01T12:00:00.000Z,257113245,2018-06-01T12:00:00.191Z
713fa586-0acf-2254-8c80-e6ed9daccb22,7696,XBt,RealisedPNL,-28593,0,Completed,XBTUSD,0c6c6f31-4d4e-3ad5-bda3-ac3091eed42e,,2018-05-31T12:00:00.000Z,257099739,2018-05-31T12:00:00.189Z
a558b4c6-b4e9-04e0-9858-ba91b07fa8e3,7696,XBt,RealisedPNL,-2947,0,Completed,XBTUSD,4bcabbd4-42e5-43d1-2fe8-7bfca7a77e34,,2018-05-30T12:00:00.000Z,257128332,2018-05-30T12:00:00.175Z
ac338128-893a-1a55-01cf-839e6306bce3,7696,XBt,RealisedPNL,-1221290,0,Completed,XBTUSD,2b1af5bd-df33-050b-e036-35c03f74f4ab,,2018-05-29T12:00:00.000Z,257131279,2018-05-29T12:00:00.199Z
673abfba-d9a4-2079-dae9-781766dd8c64,7696,XBt,RealisedPNL,364291,0,Completed,XBTUSD,f6c2d25f-0839-a38c-0c38-e8946adb7de2,,2018-05-26T12:00:00.000Z,258352569,2018-05-26T12:00:00.131Z
43abc4bc-42f4-01fb-a98f-e4ede65d1b60,7696,XBt,RealisedPNL,419219,0,Completed,XBTUSD,9035008f-3e30-8c02-1616-171c20f8df76,,2018-05-25T12:00:00.000Z,257988278,2018-05-25T12:00:00.135Z
b19f06d2-6383-fee8-cc4c-a7e6d6ebed0d,7696,XBt,RealisedPNL,39118,0,Completed,XBTUSD,9665d0e3-6fd4-5fc9-96d8-798838ed397b,,2018-05-24T12:00:00.000Z,257569059,2018-05-24T12:00:00.176Z
f8d3aee1-fa17-33cc-5814-39f01672910a,7696,XBt,RealisedPNL,-26354,0,Completed,XBTUSD,f301490d-3445-6d07-c9d8-3463d1c784f4,,2018-05-23T12:00:00.000Z,257529941,2018-05-23T12:00:00.215Z
a7e96d5d-3de8-3ae5-3c81-7dd9890a9305,7696,XBt,RealisedPNL,22831,0,Completed,XBTUSD,8b3d94af-2b5d-4876-57f0-9366c6fe0405,,2018-05-22T12:00:00.000Z,257556295,2018-05-22T12:00:00.206Z
34406e3e-2f70-59d0-52fa-b8a76fc4ffbf,7696,XBt,RealisedPNL,607236,0,Completed,XBTUSD,b973694a-04db-0111-08a9-63b3a73e324d,,2018-05-21T12:00:00.000Z,257533464,2018-05-21T12:00:00.208Z
abd06792-2e05-8580-b06b-23d96cc8da07,7696,XBt,RealisedPNL,58616,0,Completed,XBTUSD,19196f21-cedd-542a-44ab-50af2b5ab0ff,,2018-05-20T12:00:00.000Z,256926228,2018-05-20T12:00:00.206Z
5f8ceb4b-9cf0-aa7b-4dff-8d832518978a,7696,XBt,RealisedPNL,-43247,0,Completed,XBTUSD,1447d575-ded9-9a4e-e5dc-a21f66e1c945,,2018-05-19T12:00:00.000Z,256867612,2018-05-19T12:00:00.193Z
09de44b7-e01b-30bf-fc32-11d268ded224,7696,XBt,RealisedPNL,-56129,0,Completed,XBTUSD,28104bc2-f935-f043-40f8-0a4bd2226d8d,,2018-05-18T12:00:00.000Z,256910859,2018-05-18T12:00:00.207Z
72582951-69f1-52af-1a3f-6a366e166054,7696,XBt,RealisedPNL,-48765,0,Completed,XBTUSD,a502cd39-9719-9488-ea49-4f65271c724a,,2018-05-17T12:00:00.000Z,256966988,2018-05-17T12:00:00.206Z
96ad129e-7382-b90f-9d65-0cdce4d2ca09,7696,XBt,RealisedPNL,-841319,0,Completed,XBTUSD,5182938a-db23-0aeb-3b3a-4555495ee34d,,2018-05-14T12:00:00.000Z,257015753,2018-05-14T12:00:00.154Z
ec9b1436-0953-c0b3-a393-41d8becb0ea8,7696,XBt,RealisedPNL,2304,0,Completed,XBTUSD,47bfadcb-c262-3612-291d-0b4bf06dc901,,2018-05-13T12:00:00.000Z,257857072,2018-05-13T12:00:00.149Z
5569829f-1769-e7e9-1e3e-b9393dbad340,7696,XBt,RealisedPNL,-1148,0,Completed,XBTUSD,590fcd61-6354-c2c5-2775-bd735d5d1338,,2018-05-12T12:00:00.000Z,257854768,2018-05-12T12:00:00.162Z
6efe1331-f3ca-dee7-d123-bc150e8fe82c,7696,XBt,RealisedPNL,-250132,0,Completed,XBTUSD,01eba4b8-3ceb-a52b-4b2b-d51e0c4afc8d,,2018-05-11T12:00:00.000Z,257855916,2018-05-11T12:00:00.148Z
7a21e4ce-010f-a736-82ff-34cfbe68285b,7696,XBt,RealisedPNL,-327305,0,Completed,XBTUSD,f3ff5427-1a82-f3d9-6c0a-da2a7ced5cae,,2018-05-10T12:00:00.000Z,258106048,2018-05-10T12:00:00.197Z
a697c72c-8ee7-b57a-065a-7f3d79054fee,7696,XBt,RealisedPNL,-223522,0,Completed,XBTUSD,ab5900bd-3d0a-9fab-b1f9-d43e1f70c465,,2018-05-09T12:00:00.000Z,258433353,2018-05-09T12:00:00.147Z
4e8b9509-a81f-3008-c3fa-1861a1b77657,7696,XBt,RealisedPNL,-43013,0,Completed,XBTUSD,b0937142-596b-471e-600a-9a807c9b3e70,,2018-05-08T12:00:00.000Z,258656875,2018-05-08T12:00:00.129Z
8a2474fe-8a4a-99be-2911-4acc49a7ded5,7696,XBt,RealisedPNL,-138651,0,Completed,XBTUSD,c7415502-d300-2e16-0106-2ffa8a26c919,,2018-05-07T12:00:00.000Z,258699888,2018-05-07T12:00:00.133Z
e5537fc1-61e7-9d43-5aeb-8c78ac679057,7696,XBt,RealisedPNL,-2149,0,Completed,XBTUSD,d75dd585-6e56-b41b-2630-53e89d87ab09,,2018-05-06T12:00:00.000Z,258838539,2018-05-06T12:00:00.141Z
fae15381-842b-03f8-51ef-2eb243fbc580,7696,XBt,RealisedPNL,-331,0,Completed,XBTUSD,648cd367-a34e-fe6b-7f4b-bf6549674268,,2018-05-05T12:00:00.000Z,258840688,2018-05-05T12:00:00.149Z
d227369b-22f0-b761-8f61-9d5ba4d8841a,7696,XBt,RealisedPNL,87916,0,Completed,XBTUSD,52456d13-e43c-a565-4a72-a28bd903c89e,,2018-05-04T12:00:00.000Z,258841019,2018-05-04T12:00:00.141Z
ad9cd26a-0369-e532-f8cd-2fec574afc6b,7696,XBt,Deposit,244030923,,Completed,,,,2018-05-03T13:34:14.108Z,258753103,2018-05-03T13:34:14.108Z
448a8a6e-6ffa-1e5b-a9c2-a97d984fb7cd,7696,XBt,RealisedPNL,16090,0,Completed,XBTUSD,02ef5d22-ac65-629c-650f-94577d89eb83,,2018-05-03T12:00:00.000Z,14722180,2018-05-03T12:00:00.131Z
8befcb07-ce18-cfe6-2b56-4c1f40b65f18,7696,XBt,RealisedPNL,269752,0,Completed,XBTUSD,09a65ea8-9063-f8f2-9aaa-b1867887a857,,2018-05-02T12:00:00.000Z,14706090,2018-05-02T12:00:00.133Z
24f6d4ba-8e07-7246-fb73-266e83e253b5,7696,XBt,RealisedPNL,76498,0,Completed,XBTUSD,7471c6e9-996e-e489-f984-635230c264c8,,2018-05-01T12:00:00.000Z,14436338,2018-05-01T12:00:00.148Z
c20bd936-3cd1-70e0-facd-e02c97f37be6,7696,XBt,RealisedPNL,103555,0,Completed,XBTUSD,839ed032-767c-b518-6954-e70eff38af1a,,2018-04-30T12:00:00.000Z,14359840,2018-04-30T12:00:00.142Z
46b37b47-103f-4bdf-3d46-15ee62b292f4,7696,XBt,RealisedPNL,-13383,0,Completed,XBTUSD,5ac12be5-ac41-2f46-dbc2-8dba79d86cfb,,2018-04-29T12:00:00.000Z,14256285,2018-04-29T12:00:00.133Z
a0fac9ad-8e4e-87d0-36a5-67d9737ae090,7696,XBt,RealisedPNL,41209,0,Completed,XBTUSD,2e61ad56-d913-b066-81a4-154fc3b38a79,,2018-04-28T12:00:00.000Z,14269668,2018-04-28T12:00:00.138Z
62e3755b-80eb-6fc6-73d6-1e079eb63e3b,7696,XBt,RealisedPNL,-43381,0,Completed,XBTUSD,018e22b4-13a9-2517-f02e-cab37079e86a,,2018-04-27T12:00:00.000Z,14228459,2018-04-27T12:00:00.125Z
bbf42f00-11d0-fff9-87ee-b1f955ad9e86,7696,XBt,RealisedPNL,-36510,0,Completed,XBTUSD,d0b7e819-5b88-3f34-ecb0-74ec33f70c59,,2018-04-26T12:00:00.000Z,14271840,2018-04-26T12:00:00.146Z
5f695e4a-09f5-f686-c025-d9e44d8f2239,7696,XBt,RealisedPNL,-800,0,Completed,XBTUSD,adbea0b1-0912-9df7-2f4d-9743a4fd9d34,,2018-04-25T12:00:00.000Z,14308350,2018-04-25T12:00:00.182Z
cdf9bfed-4e25-7d27-fc40-6208ff4079a6,7696,XBt,RealisedPNL,-2442,0,Completed,XBTUSD,48afba2a-8d9c-7b78-34aa-8db23f93cbcf,,2018-04-24T12:00:00.000Z,14309150,2018-04-24T12:00:00.220Z
0c65327d-750a-83f7-515e-5a7b2fa289c3,7696,XBt,RealisedPNL,895425,0,Completed,XBTUSD,cf9e903b-4163-6dc2-eef5-4e30a209ab1d,,2018-04-20T12:00:00.000Z,14311592,2018-04-20T12:00:00.117Z
00d512a4-d5a4-08f8-10fb-d597450247a2,7696,XBt,RealisedPNL,-25884,0,Completed,XBTUSD,b261881a-4440-ac75-15c8-831236561c8a,,2018-04-19T12:00:00.000Z,13416167,2018-04-19T12:00:00.164Z
c38b09be-b604-7011-4363-23923b5831aa,7696,XBt,RealisedPNL,-17139,0,Completed,XBTUSD,a4f33a91-7422-8eb3-2bbf-2ad7e6888345,,2018-04-18T12:00:00.000Z,13442051,2018-04-18T12:00:00.183Z
ae9a1e56-d3ed-ae8e-6b2e-f295c204bef0,7696,XBt,RealisedPNL,-155318,0,Completed,XBTUSD,33b8795a-7698-2448-771b-cd091049c77d,,2018-04-17T12:00:00.000Z,13459190,2018-04-17T12:00:00.141Z
8d42c13c-9983-db8b-1708-18af55f5bc9f,7696,XBt,RealisedPNL,-11429,0,Completed,XBTUSD,a356c323-59bb-ee97-9bf9-ca44e4958e2c,,2018-04-16T12:00:00.000Z,13614508,2018-04-16T12:00:00.176Z
eb6492ca-1fdd-ab61-67af-68b1eb36c07a,7696,XBt,RealisedPNL,-432,0,Completed,XBTUSD,0b259e2e-1aad-974c-4c3e-3b744b6f6707,,2018-04-13T12:00:00.000Z,13625937,2018-04-13T12:00:00.182Z
7950c41d-657d-5101-aae3-042b90c362e5,7696,XBt,RealisedPNL,68792,0,Completed,XBTUSD,933a2d0b-d99b-a726-e619-cdd0ae26e209,,2018-04-11T12:00:00.000Z,13626369,2018-04-11T12:00:00.175Z
49abe640-bd9c-156d-1bd8-39b27c15e966,7696,XBt,RealisedPNL,-98993,0,Completed,XBTUSD,0088ef8f-7bb6-d6be-cacd-f7f63ebdf5a6,,2018-04-10T12:00:00.000Z,13557577,2018-04-10T12:00:00.174Z
5c0c2d8a-7030-a98c-65c6-430fddaad441,7696,XBt,RealisedPNL,15303,0,Completed,XBTUSD,ae8d92d3-41de-5853-3961-7126db345d83,,2018-04-09T12:00:00.000Z,13656570,2018-04-09T12:00:00.216Z
88b6d558-a27a-0794-c2d0-fbd84e6a7382,7696,XBt,RealisedPNL,10767,0,Completed,XBTUSD,f4b75ef4-2c77-5a48-4678-c3d69bdacbee,,2018-04-08T12:00:00.000Z,13641267,2018-04-08T12:00:00.206Z
e9c4c5e9-6254-ddbe-b560-831cbdcd66cd,7696,XBt,RealisedPNL,-38804,0,Completed,XBTUSD,d9e17479-c9f2-b03b-d712-b3bfdfef1672,,2018-04-07T12:00:00.000Z,13630500,2018-04-07T12:00:00.161Z
345e3d17-a6aa-0810-bfd1-64208ef40f92,7696,XBt,RealisedPNL,-57034,0,Completed,XBTUSD,c45bf16f-3653-a0d5-14de-c5dd1af54e3e,,2018-04-06T12:00:00.000Z,13669304,2018-04-06T12:00:00.189Z
57b2313a-3dba-4697-0b12-898c97d88609,7696,XBt,RealisedPNL,-223497,0,Completed,XBTUSD,117ba0c7-395d-911a-9dd9-15e6aa08993d,,2018-04-05T12:00:00.000Z,13726338,2018-04-05T12:00:00.171Z
dc82037d-8240-7b17-91d8-f8170765f761,7696,XBt,RealisedPNL,14757,0,Completed,XBTUSD,3e177924-f874-8b3c-e263-9619c022ad00,,2018-04-04T12:00:00.000Z,13949835,2018-04-04T12:00:00.170Z
ab3fd699-c4ec-9dca-bca6-2cc1c7c3576d,7696,XBt,RealisedPNL,-2052,0,Completed,XBTUSD,ba46071c-d1f6-28b3-bc5a-370b8a069fee,,2018-04-03T12:00:00.000Z,13935078,2018-04-03T12:00:00.116Z
713470dc-f64b-3cdb-470f-f5270d4529af,7696,XBt,RealisedPNL,-94143,0,Completed,XBTUSD,8b1e2d61-35ad-aa65-f3a6-8b8982cd5cd3,,2018-03-29T12:00:00.000Z,13937130,2018-03-29T12:00:00.136Z
51ca0247-da78-0584-b197-1b1e81ee8cd3,7696,XBt,RealisedPNL,-73934,0,Completed,XBTUSD,1266a691-a2f6-7337-a87a-54c03d88bb41,,2018-03-28T12:00:00.000Z,14031273,2018-03-28T12:00:00.130Z
7058e920-9246-e8cd-ea11-b80682a89fb5,7696,XBt,RealisedPNL,-85643,0,Completed,XBTUSD,1e26dd78-e830-eff4-f8c2-342aeeca7f19,,2018-03-27T12:00:00.000Z,14105207,2018-03-27T12:00:00.135Z
7b9b5ea2-9f7b-8fa8-6446-3eee347983f6,7696,XBt,RealisedPNL,16157,0,Completed,XBTUSD,d0d74143-ea89-843a-6650-1466c129363f,,2018-03-26T12:00:00.000Z,14190850,2018-03-26T12:00:00.137Z
7f0d2c83-79fa-f703-845f-4eda0b363a6c,7696,XBt,RealisedPNL,948,0,Completed,XBTUSD,38cd7322-0eb4-0bff-bd50-f1de841ab790,,2018-03-25T12:00:00.000Z,14174693,2018-03-25T12:00:00.134Z
d962e1ab-df59-ba48-d62a-3fd58fffdd0f,7696,XBt,RealisedPNL,11806,0,Completed,XBTUSD,fa4d35d9-cac0-5256-8a90-2902131c8323,,2018-03-24T12:00:00.000Z,14173745,2018-03-24T12:00:00.134Z
4ad9c229-af5e-b8c8-5eac-06eb61abaf36,7696,XBt,RealisedPNL,-668,0,Completed,XBTUSD,d06dd168-c642-b107-0920-baf2278ba032,,2018-03-23T12:00:00.000Z,14161939,2018-03-23T12:00:00.130Z
fabf128e-5c85-bdde-7a09-a9fbc176f6c5,7696,XBt,RealisedPNL,201,0,Completed,XBTUSD,14276ca5-b9e4-bee1-8b1a-3ed4428cc56c,,2018-03-22T12:00:00.000Z,14162607,2018-03-22T12:00:00.168Z
45197b0c-4e07-0362-51a3-45ea5131961d,7696,XBt,RealisedPNL,-1510,0,Completed,XBTUSD,228c0666-b946-7261-4dd6-4f517c195f00,,2018-03-21T12:00:00.000Z,14162406,2018-03-21T12:00:00.163Z
fe0d17f4-ae16-2713-38ae-b054bac7fec6,7696,XBt,RealisedPNL,-7164,0,Completed,XBTUSD,91594a45-2cc7-4855-595e-9ea18408e959,,2018-03-20T12:00:00.000Z,14163916,2018-03-20T12:00:00.182Z
d8621e70-f42a-1af5-663f-e866acbf6b3f,7696,XBt,RealisedPNL,-8611,0,Completed,XBTUSD,435940b6-da3a-e318-a418-ea4b6a9b04d1,,2018-03-19T12:00:00.000Z,14171080,2018-03-19T12:00:00.133Z
5b7eb583-3082-092a-b4f1-fd9701e47bbe,7696,XBt,RealisedPNL,-8545,0,Completed,XBTUSD,ed665c0e-1f3e-05d9-f5ff-26db9f0b01bd,,2018-03-18T12:00:00.000Z,14179691,2018-03-18T12:00:00.190Z
2efe490b-4038-acda-d059-e9767300eb50,7696,XBt,RealisedPNL,-8118,0,Completed,XBTUSD,2f271e25-0b31-765c-3360-5661680f6e80,,2018-03-17T12:00:00.000Z,14188236,2018-03-17T12:00:00.176Z
511f00b9-4433-924c-daa5-3ef0347e9f94,7696,XBt,RealisedPNL,-5592,0,Completed,XBTUSD,b5ec1e6d-dcb4-c813-c3ed-96da9cd0ae12,,2018-03-16T12:00:00.000Z,14196354,2018-03-16T12:00:00.109Z
41b90eb1-fadd-95a4-01ed-fdb447939ce8,7696,XBt,RealisedPNL,-403683,0,Completed,XBTUSD,c8aa8b8f-9e26-4654-4874-af411b115190,,2018-03-15T12:00:00.000Z,14201946,2018-03-15T12:00:00.189Z
51f0baf4-814f-2d09-5160-829d26557fbf,7696,XBt,RealisedPNL,548,0,Completed,XBTUSD,3b27cf29-1480-d321-0689-21a70d999d2f,,2018-03-14T12:00:00.000Z,14605629,2018-03-14T12:00:00.145Z
cdefb24c-1f02-a1a0-8d65-4c9da54ac89e,7696,XBt,RealisedPNL,-32081,0,Completed,XBTUSD,eca89dd4-8e5c-f208-c5ee-3243fb948eb4,,2018-03-12T12:00:00.000Z,14605081,2018-03-12T12:00:00.112Z
8d68a270-be58-e95e-17cc-1a3d8f2934e5,7696,XBt,RealisedPNL,-249,0,Completed,XBTUSD,7cfbf8f1-c7a1-f710-423d-ce6d0f5d10f3,,2018-03-11T12:00:00.000Z,14637162,2018-03-11T12:00:00.106Z
e6d91e54-1740-aeb7-098d-d1656a9a56ba,7696,XBt,RealisedPNL,-181108,0,Completed,XBTUSD,3be9f0aa-051b-ea60-9f0f-67c01c63ea10,,2018-03-10T12:00:00.000Z,14637411,2018-03-10T12:00:00.111Z
6d484355-089f-801b-64f6-9977ed82442d,7696,XBt,RealisedPNL,3052,0,Completed,XBTUSD,69b0cfba-36d8-2a32-5385-9b9c5297df87,,2018-03-09T12:00:00.000Z,14818519,2018-03-09T12:00:00.112Z
7a8ea0b1-0bf2-13f6-91cc-fd01cad595ab,7696,XBt,RealisedPNL,25830,0,Completed,XBTUSD,7ab56b30-4d1f-f51a-e807-cdf919f149d4,,2018-03-08T12:00:00.000Z,14815467,2018-03-08T12:00:00.106Z
2ef78b3c-64df-a40c-236b-6b914b4a04dc,7696,XBt,RealisedPNL,-4254,0,Completed,XBTUSD,96fefc53-7cc2-5b6f-acf4-b30b2ab33cbb,,2018-03-07T12:00:00.000Z,14789637,2018-03-07T12:00:00.102Z
ebcb2187-7f24-153b-b259-d757a6bd8318,7696,XBt,RealisedPNL,-5323,0,Completed,XBTUSD,73da2928-fdc7-21bc-0fe9-30d09d25cfcd,,2018-03-06T12:00:00.000Z,14793891,2018-03-06T12:00:00.094Z
389ed025-2aea-dfb0-94d4-cb1090260977,7696,XBt,RealisedPNL,-9313,0,Completed,XBTUSD,964cb760-9005-c0fb-0932-4e78571a01c6,,2018-03-05T12:00:00.000Z,14799214,2018-03-05T12:00:00.160Z
03ea2f0f-ff0c-a032-f609-31cc7264a76c,7696,XBt,RealisedPNL,-2043,0,Completed,XBTUSD,869aa290-1831-aaa0-f111-50d7cc8e71aa,,2018-03-04T12:00:00.000Z,14808527,2018-03-04T12:00:00.169Z
3f1eb435-c3ce-2859-3ef7-b32f2970b672,7696,XBt,RealisedPNL,9572,0,Completed,XBTUSD,a5e667d9-7e61-1352-b92a-6ed4970a6a2f,,2018-03-03T12:00:00.000Z,14810570,2018-03-03T12:00:00.120Z
7bef4c8c-1898-f69b-4659-0aa7a633147b,7696,XBt,RealisedPNL,10445,0,Completed,XBTUSD,a7f98322-46d5-c01f-710e-3819e4a3e1e9,,2018-03-02T12:00:00.000Z,14800998,2018-03-02T12:00:00.116Z
2539ec66-ea00-9e83-d254-dd15e0ede491,7696,XBt,RealisedPNL,10839,0,Completed,XBTUSD,d4e810ae-6dd3-05e4-0220-3db8b2c6a561,,2018-03-01T12:00:00.000Z,14790553,2018-03-01T12:00:00.120Z
affbcf7a-a6b5-fc09-006d-a31de4417ddd,7696,XBt,RealisedPNL,6191,0,Completed,XBTUSD,550ae6a5-e0ab-f1ec-d6f8-6e1c1476c70e,,2018-02-28T12:00:00.000Z,14779714,2018-02-28T12:00:00.154Z
2d878fa7-36c4-97b7-003a-749be455246a,7696,XBt,RealisedPNL,-153242,0,Completed,XBTUSD,7f9f2fe0-a7b2-23cc-fea9-d1e871c4e080,,2018-02-27T12:00:00.000Z,14773523,2018-02-27T12:00:00.164Z
9f0e8fd6-c64a-35f0-e485-c5cec9434d26,7696,XBt,RealisedPNL,-2113,0,Completed,XBTUSD,b3a6fb60-053a-d554-59ad-12d2bf913c79,,2018-02-26T12:00:00.000Z,14926765,2018-02-26T12:00:00.158Z
5a856523-2a4e-13b2-c00d-c2cd78e105e9,7696,XBt,RealisedPNL,-13895,0,Completed,XBTUSD,e0d98b77-a574-7e9f-67cd-1d8e397addf3,,2018-02-25T12:00:00.000Z,14928878,2018-02-25T12:00:00.166Z
acc49884-e1ae-1b42-5462-df9748e2c1df,7696,XBt,RealisedPNL,-19086,0,Completed,XBTUSD,934bb927-790d-c76b-9260-073b531dab62,,2018-02-24T12:00:00.000Z,14942773,2018-02-24T12:00:00.153Z
ccc53e1b-75d6-8966-e338-8f2dd7137e59,7696,XBt,RealisedPNL,-33514,0,Completed,XBTUSD,9526eafb-effc-a0fb-486f-bac2f8bb3b0c,,2018-02-23T12:00:00.000Z,14961859,2018-02-23T12:00:00.101Z
16acaca8-e504-8729-d454-8557987bfacc,7696,XBt,RealisedPNL,-31443,0,Completed,XBTUSD,13fca511-ad1e-8d18-4c29-c96b2db84a53,,2018-02-22T12:00:00.000Z,14995373,2018-02-22T12:00:00.119Z
53189f9f-dc7a-920c-6e93-eda11e484cc1,7696,XBt,RealisedPNL,-2634211,0,Completed,XBTUSD,fb16b727-740d-4cb9-90f2-93d6b130d11a,,2018-02-21T12:00:00.000Z,15026816,2018-02-21T12:00:00.131Z
0e682e99-ce83-67f2-f4a0-a7b273283cbf,7696,XBt,RealisedPNL,-43420,0,Completed,XBTUSD,8e4120e9-2d63-15d3-115e-1ee78d266022,,2018-02-20T12:00:00.000Z,17661027,2018-02-20T12:00:00.111Z
04a1dd69-269f-8025-194c-389d86c91f11,7696,XBt,RealisedPNL,-61058,0,Completed,XBTUSD,e7740cba-bcd9-bd83-db92-78c13d028824,,2018-02-19T12:00:00.000Z,17704447,2018-02-19T12:00:00.100Z
e27eab48-cb77-0c24-4914-eab1b76d4fad,7696,XBt,RealisedPNL,21865,0,Completed,XBTUSD,618ac2a3-93e8-4d78-f105-f50331015ab3,,2018-02-18T12:00:00.000Z,17765505,2018-02-18T12:00:00.100Z
5ce0ce0e-5b4e-cb79-0f9c-9d2c35f419e1,7696,XBt,RealisedPNL,-81674,0,Completed,XBTUSD,37906eb6-0249-5904-3c84-6a3fcdceeea4,,2018-02-17T12:00:00.000Z,17743640,2018-02-17T12:00:00.103Z
fe38f65b-d47b-4a4f-e7b9-3a5932648465,7696,XBt,RealisedPNL,-88343,0,Completed,XBTUSD,8e26a755-b41d-9034-d78a-61bf58356f2c,,2018-02-16T12:00:00.000Z,17825314,2018-02-16T12:00:00.124Z
122d6afe-f301-a92e-511a-d5c2d95fafd3,7696,XBt,RealisedPNL,-97451,0,Completed,XBTUSD,ae4b81e5-dd7d-2e27-d9d7-557361ecf733,,2018-02-15T12:00:00.000Z,17913657,2018-02-15T12:00:00.124Z
5af2a345-d273-8d62-30e0-1de3cf4e7cae,7696,XBt,RealisedPNL,-71213,0,Completed,XBTUSD,bcc34974-5b93-b9ef-3224-79a41924db0c,,2018-02-14T12:00:00.000Z,18011108,2018-02-14T12:00:00.084Z
d0257d4a-87d2-44df-92be-e8fc72b319b9,7696,XBt,RealisedPNL,-65058,0,Completed,XBTUSD,e57d221d-0e12-fd45-f49a-34153529cf19,,2018-02-13T12:00:00.000Z,18082321,2018-02-13T12:00:00.075Z
32489f2f-5b67-9c79-4442-d9bba3699a60,7696,XBt,RealisedPNL,-68320,0,Completed,XBTUSD,a292d666-ff62-ccce-f6d1-aecb10fc05df,,2018-02-12T12:00:00.000Z,18147379,2018-02-12T12:00:00.096Z
17b58d14-20f7-2308-bc2b-f311a0564211,7696,XBt,RealisedPNL,-67773,0,Completed,XBTUSD,c03e0074-f32f-dfc3-2c7f-e607ebd2d40b,,2018-02-11T12:00:00.000Z,18215699,2018-02-11T12:00:00.138Z
42eda85c-cd5c-f4d1-3a4f-58919db78793,7696,XBt,RealisedPNL,-66139,0,Completed,XBTUSD,68822382-aa3a-6094-f1f4-c9246c81247a,,2018-02-10T12:00:00.000Z,18283472,2018-02-10T12:00:00.163Z
b614f6bd-4074-f177-b0d9-012ded461249,7696,XBt,RealisedPNL,2006205,0,Completed,XBTUSD,9458ae5d-5550-01a5-e470-417250b5bdc9,,2018-02-09T12:00:00.000Z,18349611,2018-02-09T12:00:00.093Z
13393bb9-4f2a-c75f-5de2-1ca1ae36830a,7696,XBt,RealisedPNL,68396,0,Completed,XBTUSD,5bf5481a-f096-8692-630e-c98765ba1814,,2018-02-08T12:00:00.000Z,16343406,2018-02-08T12:00:00.070Z
70bcad63-d89d-d53e-4197-97cdaa356066,7696,XBt,RealisedPNL,78807,0,Completed,XBTUSD,d32ceb8e-35b9-ace9-df6a-2ae88e920a5d,,2018-02-07T12:00:00.000Z,16275010,2018-02-07T12:00:00.106Z
f6267ab2-74ac-6a59-f3a6-28b14dcdd85b,7696,XBt,RealisedPNL,2762922,0,Completed,XBTUSD,9051728d-0ffc-0270-16f5-9c601ae02b9f,,2018-02-06T12:00:00.000Z,16196203,2018-02-06T12:00:00.100Z
afa8f3cc-08ae-d3db-d4c0-274d0c6a0011,7696,XBt,RealisedPNL,1107279,0,Completed,XBTUSD,47eb2289-ecf2-2985-5eb2-2cfb18b42910,,2018-02-05T12:00:00.000Z,13433281,2018-02-05T12:00:00.120Z
5ace88a2-a119-2b3a-fd40-52671a8472a1,7696,XBt,RealisedPNL,-57804,0,Completed,XBTUSD,2a47b0a4-53c5-b18e-7b6f-7f73a2ae951f,,2018-02-04T12:00:00.000Z,12326002,2018-02-04T12:00:00.123Z
b58243c0-155e-aff3-7648-3bcfb702a9b8,7696,XBt,RealisedPNL,-31411,0,Completed,XBTUSD,d6474b13-e819-f424-3b9c-f6728dfbbe9b,,2018-02-03T12:00:00.000Z,12383806,2018-02-03T12:00:00.165Z
1d9908bf-e1e4-1302-5d36-8ef5eda96998,7696,XBt,RealisedPNL,44530,0,Completed,XBTUSD,914668c5-3ad1-25a0-8151-88eec7f71eb0,,2018-02-02T12:00:00.000Z,12415217,2018-02-02T12:00:00.162Z
c7cbb0cc-ab22-344a-68cf-cb22054a1f9f,7696,XBt,RealisedPNL,40322,0,Completed,XBTUSD,3221def2-901d-2bdb-1ea6-a39d7e257dd3,,2018-02-01T12:00:00.000Z,12370687,2018-02-01T12:00:00.163Z
5386cb61-beac-31b3-4414-4346b21c90e6,7696,XBt,RealisedPNL,1464,0,Completed,XBTUSD,f4036fc8-cd34-31c7-268f-29b4602e2e65,,2018-01-31T12:00:00.000Z,12330365,2018-01-31T12:00:00.163Z
12565afb-9405-eb25-e44d-2d4bc8b0d93a,7696,XBt,RealisedPNL,1369,0,Completed,XBTUSD,21ecb6d4-28e6-e32b-5a1d-19285707039b,,2018-01-30T12:00:00.000Z,12328901,2018-01-30T12:00:00.081Z
bbab7fe3-31d0-dde5-7aa4-f9174efbcc66,7696,XBt,RealisedPNL,1310,0,Completed,XBTUSD,a36f7bc8-a977-60af-79b9-775fad2cbd7a,,2018-01-29T12:00:00.000Z,12327532,2018-01-29T12:00:00.075Z
1f791d8f-ce8f-f36e-a465-6682bfc26c1a,7696,XBt,RealisedPNL,1342,0,Completed,XBTUSD,0729c16d-03dd-4b9b-34ee-ac1ff3e42615,,2018-01-28T12:00:00.000Z,12326222,2018-01-28T12:00:00.074Z
b4c36451-848d-1318-0087-b5bdde56d1ac,7696,XBt,RealisedPNL,1394,0,Completed,XBTUSD,9fe893cc-8d4a-0ec9-f419-24cabae82e9a,,2018-01-27T12:00:00.000Z,12324880,2018-01-27T12:00:00.124Z
f3bfb34a-6885-afcc-3855-ea8d24167048,7696,XBt,RealisedPNL,1336,0,Completed,XBTUSD,c9e5e7ff-bc07-3f29-dd11-32eb3005c6ae,,2018-01-26T12:00:00.000Z,12323486,2018-01-26T12:00:00.101Z
f8b607d5-382e-476d-c1f3-4a3a01ffffc5,7696,XBt,RealisedPNL,1339,0,Completed,XBTUSD,9e44fd25-eeb7-00ee-38a1-6db304e4f66d,,2018-01-25T12:00:00.000Z,12322150,2018-01-25T12:00:00.147Z
aa26dfc6-cace-6c41-bee5-7b052bf85b94,7696,XBt,RealisedPNL,1416,0,Completed,XBTUSD,96fc268b-d133-9ec9-b09c-4ce03b25e730,,2018-01-24T12:00:00.000Z,12320811,2018-01-24T12:00:00.119Z
94d0ddec-3ccb-f7c5-0924-eca7a2f0780f,7696,XBt,RealisedPNL,1383,0,Completed,XBTUSD,83703bba-2902-32fb-b701-8f90c8935a48,,2018-01-23T12:00:00.000Z,12319395,2018-01-23T12:00:00.108Z
de31ea74-a16c-f912-0206-151a768a518d,7696,XBt,RealisedPNL,1288,0,Completed,XBTUSD,a2399df5-5885-5b86-54cb-e0d5dfa6aa04,,2018-01-22T12:00:00.000Z,12318012,2018-01-22T12:00:00.140Z
d4fcb313-5818-abf2-f1f0-3fc3ff37ba0d,7696,XBt,RealisedPNL,1204,0,Completed,XBTUSD,dd5adf53-cde6-d931-0447-51b1a4885766,,2018-01-21T12:00:00.000Z,12316724,2018-01-21T12:00:00.107Z
bbbfa890-5a45-c05f-c97c-5a97dc07ede9,7696,XBt,RealisedPNL,976,0,Completed,XBTUSD,e825180d-fb6f-01e1-d9aa-cbe091d82fe2,,2018-01-20T12:00:00.000Z,12315520,2018-01-20T12:00:00.123Z
71568e8d-1b10-9123-2e82-5376cc461b4c,7696,XBt,RealisedPNL,-26860,0,Completed,XBTUSD,db71a793-2d8d-fc01-558b-a7e356ef9d50,,2018-01-19T12:00:00.000Z,12314544,2018-01-19T12:00:00.073Z
cd0dce65-3f8f-31df-7a01-865478f9dd88,7696,XBt,RealisedPNL,-41782,0,Completed,XBTUSD,dcc472d0-afb9-46a9-c116-4b4350154029,,2018-01-18T12:00:00.000Z,12341404,2018-01-18T12:00:00.071Z
ec312a17-d926-a69d-8687-27168b08ed5e,7696,XBt,RealisedPNL,41944,0,Completed,XBTUSD,2e41a9f2-0327-09d2-d714-93bee757c650,,2018-01-17T12:00:00.000Z,12383186,2018-01-17T12:00:00.076Z
f0579d78-db60-a0d3-973e-a910caf3b25c,7696,XBt,RealisedPNL,29245,0,Completed,XBTUSD,22d3fcc1-6083-cdbe-fd87-82ff25d1f357,,2018-01-16T12:00:00.000Z,12341242,2018-01-16T12:00:00.117Z
b05728dc-23a3-6fd8-05a5-b7b15e1c264e,7696,XBt,RealisedPNL,-21552,0,Completed,XBTUSD,ccccf3af-43e8-a105-2f1f-4a427bd887d3,,2018-01-15T12:00:00.000Z,12311997,2018-01-15T12:00:00.076Z
91af7425-1285-5bd3-d8b1-73f50cc864d3,7696,XBt,RealisedPNL,-25537,0,Completed,XBTUSD,da0d1419-fb07-f9d8-3e24-461c91491b73,,2018-01-14T12:00:00.000Z,12333549,2018-01-14T12:00:00.112Z
5ce598af-bf04-03f6-aff4-48fafd514eb2,7696,XBt,RealisedPNL,29482,0,Completed,XBTUSD,2f15d7e8-7b7b-4172-413e-01f03a5cdc40,,2018-01-13T12:00:00.000Z,12359086,2018-01-13T12:00:00.098Z
75b1a231-8c84-2eaf-7de4-ddd577b9766a,7696,XBt,RealisedPNL,-81320,0,Completed,XBTUSD,95bac34c-ce36-df6a-9fa7-c470bdeaadbc,,2018-01-12T12:00:00.000Z,12329604,2018-01-12T12:00:00.098Z
bc82733e-ef6d-88ac-98d8-0267b15d25c1,7696,XBt,RealisedPNL,-483195,0,Completed,XBTUSD,ff121f57-71b3-8953-87fe-568478a565d6,,2018-01-11T12:00:00.000Z,12410924,2018-01-11T12:00:00.096Z
dedc5cd5-93fc-a2b2-995c-cddc2f0bd944,7696,XBt,RealisedPNL,-1016064,0,Completed,XBTUSD,cb89777c-6ad1-5749-f892-e54a04f74cb1,,2018-01-10T12:00:00.000Z,12894119,2018-01-10T12:00:00.093Z
e3ec86d9-6f20-ecc8-c0bd-80a3e8d4d780,7696,XBt,RealisedPNL,56646,0,Completed,XBTUSD,043e0dd8-bcb0-996e-c8b3-a1e60a0f6c66,,2018-01-09T12:00:00.000Z,13910183,2018-01-09T12:00:00.106Z
5f805b2b-0d2f-3b2c-5265-a86c8c22db29,7696,XBt,RealisedPNL,119479,0,Completed,XBTUSD,fad7500e-6ae4-7b4b-7198-862d0cc88a36,,2018-01-08T12:00:00.000Z,13853537,2018-01-08T12:00:00.107Z
615d7b03-7ccc-f6e3-65e8-dce1b975d3e3,7696,XBt,RealisedPNL,150313,0,Completed,XBTUSD,e6d53bb6-39fe-5f11-8f42-c3f6832cc7ef,,2018-01-07T12:00:00.000Z,13734058,2018-01-07T12:00:00.059Z
fd480086-e836-4172-8cac-40b8d442b3d2,7696,XBt,RealisedPNL,-70357,0,Completed,XBTUSD,9a35805d-d002-46c8-b9cf-74b995808dc1,,2018-01-06T12:00:00.000Z,13583745,2018-01-06T12:00:00.135Z
df863376-4923-e39f-db21-c88621803922,7696,XBt,RealisedPNL,1209553,0,Completed,XBTUSD,d564ea07-abcd-061d-2123-ed4bcd389484,,2018-01-05T12:00:00.000Z,13654102,2018-01-05T12:00:00.124Z
16eb496e-19af-ddbb-61ce-db9b6734cc86,7696,XBt,RealisedPNL,140891,0,Completed,XBTUSD,64988a92-5404-c1ed-1b7c-d266a02b40d2,,2018-01-04T12:00:00.000Z,12444549,2018-01-04T12:00:00.145Z
f84211aa-28fd-6bc9-e41e-d22cc844c1f3,7696,XBt,RealisedPNL,204342,0,Completed,XBTUSD,eb8d33ab-9bd0-a022-6ab9-33946b26738c,,2018-01-03T12:00:00.000Z,12303658,2018-01-03T12:00:00.108Z
b854faf5-5a03-958b-65bf-de9a7b6ecbb3,7696,XBt,RealisedPNL,136669,0,Completed,XBTUSD,62ed7854-190b-8a90-038f-4018fc85c943,,2018-01-02T12:00:00.000Z,12099316,2018-01-02T12:00:00.116Z
f91a1b38-3499-62c0-a81f-d82794fe1e44,7696,XBt,RealisedPNL,114192,0,Completed,XBTUSD,da1efdbb-d549-26d1-0959-a192175d042a,,2018-01-01T12:00:00.000Z,11962647,2018-01-01T12:00:00.103Z
0c1959f1-703d-b347-e1d9-90a02fad8203,7696,XBt,RealisedPNL,155570,0,Completed,XBTUSD,ddb0389e-17c9-5b9a-c351-93d82b165ddb,,2017-12-31T12:00:00.000Z,11848455,2017-12-31T12:00:00.106Z
22db2356-bae0-7c29-4f52-73f46990910a,7696,XBt,RealisedPNL,162350,0,Completed,XBTUSD,7e9bf374-6b42-47e0-252e-172fce9bf3be,,2017-12-30T12:00:00.000Z,11692885,2017-12-30T12:00:00.106Z
c6b6eea8-d74b-7b78-63af-bef9c4f5e492,7696,XBt,RealisedPNL,221562,0,Completed,XBTUSD,facfed4d-bc6e-2da0-df3b-6a2e1aced503,,2017-12-29T12:00:00.000Z,11530535,2017-12-29T12:00:00.108Z
8f113185-31ae-4992-22da-135b77a6505d,7696,XBt,RealisedPNL,185510,0,Completed,XBTUSD,08c5b259-47f8-a773-4d36-1892414a15ad,,2017-12-28T12:00:00.000Z,11308973,2017-12-28T12:00:00.103Z
8f5beada-4efa-2481-85a5-41b34f5c825e,7696,XBt,RealisedPNL,202586,0,Completed,XBTUSD,823d7f68-70df-d2c1-e483-14da9ecc891f,,2017-12-27T12:00:00.000Z,11123463,2017-12-27T12:00:00.107Z
27006725-6bc6-9296-7a43-fbf69fa8e2d1,7696,XBt,RealisedPNL,218867,0,Completed,XBTUSD,84191df3-9c3f-ac45-c28f-b0dc180a7dab,,2017-12-26T12:00:00.000Z,10920877,2017-12-26T12:00:00.106Z
aad87567-af65-c191-32dc-85928d97c53a,7696,XBt,RealisedPNL,234787,0,Completed,XBTUSD,e125fbf3-6081-857f-67b8-2ea7b8edcdb9,,2017-12-25T12:00:00.000Z,10702010,2017-12-25T12:00:00.096Z
570d27d3-2723-8fef-daa9-c328c7b91eef,7696,XBt,RealisedPNL,210505,0,Completed,XBTUSD,d1e1666e-1ed4-eff1-65bb-4de9d2670e89,,2017-12-24T12:00:00.000Z,10467223,2017-12-24T12:00:00.103Z
4fa5c664-8d45-3fd4-7777-afb64af281d5,7696,XBt,RealisedPNL,79755,0,Completed,XBTUSD,504b42c5-29a1-b73d-7fa7-55aff33daddc,,2017-12-23T12:00:00.000Z,10256718,2017-12-23T12:00:00.107Z
972b974a-ed06-c2c6-0904-a5cfb7bacb6a,7696,XBt,RealisedPNL,-45626,0,Completed,XBTUSD,f8b04852-0632-2741-7b76-69d72db6d18e,,2017-12-22T12:00:00.000Z,10176963,2017-12-22T12:00:00.104Z
bc0e9eee-da17-ee41-2c14-39714d5c92a5,7696,XBt,RealisedPNL,-8883,0,Completed,XBTUSD,b0b98ddc-8b33-7928-7050-0b2628d158e1,,2017-12-21T12:00:00.000Z,10222589,2017-12-21T12:00:00.103Z
624c6640-e2c2-8c42-9ac7-c02fa6b14abb,7696,XBt,RealisedPNL,14198,0,Completed,XBTUSD,d0f2dd9b-e701-2e9d-e104-caafd60c8412,,2017-12-20T12:00:00.000Z,10231472,2017-12-20T12:00:00.102Z
c4213927-0963-3ead-1672-8e0413c6f81f,7696,XBt,RealisedPNL,2914,0,Completed,XBTUSD,4107ef40-5323-2b4f-eebd-44cd13788c9d,,2017-12-19T12:00:00.000Z,10217274,2017-12-19T12:00:00.056Z
a7c6a4c5-4bca-30d5-ffef-2de03ff1b7ba,7696,XBt,RealisedPNL,228697,0,Completed,XBTUSD,29f851d4-f2dc-f4c0-c87b-d8db2f9b7018,,2017-11-15T12:00:00.000Z,10214360,2017-11-15T12:00:00.074Z
72f73abd-36b2-4046-d6b8-fe3ad277cf39,7696,XBt,RealisedPNL,-105,0,Completed,XBTUSD,1070b688-03a4-ceff-b731-9c183cc04968,,2017-11-14T12:00:00.000Z,9985663,2017-11-14T14:58:40.011Z
8ac38d92-a2eb-76b0-5424-1113f89284c5,7696,XBt,RealisedPNL,-112,0,Completed,XBTUSD,5e2728ea-6135-b8e1-203f-8e98a98892f1,,2017-11-13T12:00:00.000Z,9985768,2017-11-13T12:00:00.047Z
13881250-cfb9-587f-0fd0-43e8b851503b,7696,XBt,RealisedPNL,-109,0,Completed,XBTUSD,45a1cea3-b778-2795-7bef-66799799f97e,,2017-11-12T12:00:00.000Z,9985880,2017-11-12T12:00:00.047Z
4b3dfd80-71de-a3b4-257a-9e0fa886b4ad,7696,XBt,RealisedPNL,-102,0,Completed,XBTUSD,a6823122-1e7c-211c-4221-d32cb7926922,,2017-11-11T12:00:00.000Z,9985989,2017-11-11T12:00:00.046Z
9f7e0bd1-2246-8c3f-6759-5846732df17d,7696,XBt,RealisedPNL,-96,0,Completed,XBTUSD,db909d8c-d148-be56-190f-40c3d0a12e46,,2017-11-10T12:00:00.000Z,9986091,2017-11-10T12:00:00.050Z
3fa3943d-8c4b-41c3-9610-65c8a047916f,7696,XBt,RealisedPNL,-94,0,Completed,XBTUSD,aec25e33-9879-d127-f8c4-b301e57ee178,,2017-11-09T12:00:00.000Z,9986187,2017-11-09T12:00:00.009Z
c6c3fda1-896a-06f8-95f6-d675d2e9af40,7696,XBt,RealisedPNL,-95,0,Completed,XBTUSD,19faaaa7-5f2b-4e8f-61cc-92053970b9b9,,2017-11-08T12:00:00.000Z,9986281,2017-11-08T12:00:00.282Z
6066f4ef-ee43-9002-7e6a-6c9408cebea1,7696,XBt,RealisedPNL,-96,0,Completed,XBTUSD,9bfde99a-b1d8-d8b4-f762-fa03b4b28ea7,,2017-11-07T12:00:00.000Z,9986376,2017-11-07T12:00:00.315Z
f125cd24-54d0-0ce2-ab1c-ae8ba8f0e1a9,7696,XBt,RealisedPNL,-92,0,Completed,XBTUSD,6281ae94-0067-cfe9-8953-c5a91aadb1f5,,2017-11-06T12:00:00.000Z,9986472,2017-11-06T12:00:00.234Z
b3500984-6e3b-307c-8abc-2b3a72b7b151,7696,XBt,RealisedPNL,-94,0,Completed,XBTUSD,ef94d9df-36ee-8317-c75d-01d39df9ac28,,2017-11-05T12:00:00.000Z,9986564,2017-11-05T12:00:00.207Z
4f7fbb8e-7878-0b24-7798-0749465034f8,7696,XBt,RealisedPNL,-95,0,Completed,XBTUSD,7594c99d-836c-b74c-b6e3-11c0ad0a3f82,,2017-11-04T12:00:00.000Z,9986658,2017-11-04T12:00:00.418Z
505c5509-5cf9-000a-1a2e-441f9dc88818,7696,XBt,RealisedPNL,-98,0,Completed,XBTUSD,48b4d40a-c32d-861b-74d0-12b0d1e8e866,,2017-11-03T12:00:00.000Z,9986753,2017-11-03T12:00:00.307Z
496401af-ad7b-4c8b-9b0f-e444686418d0,7696,XBt,RealisedPNL,-103,0,Completed,XBTUSD,4c6405f4-3e61-ba5e-ec72-f103758c4963,,2017-11-02T12:00:00.000Z,9986851,2017-11-02T12:00:00.262Z
b9cc6bc3-17bc-85c1-6a49-c99dc9209b34,7696,XBt,RealisedPNL,-109,0,Completed,XBTUSD,e1d5099f-d362-558e-aece-938a844595d6,,2017-11-01T12:00:00.000Z,9986954,2017-11-01T12:00:00.263Z
39cc7169-84ab-fe58-57e9-a99b4be4841a,7696,XBt,RealisedPNL,-113,0,Completed,XBTUSD,9eea3f48-0a8b-68a0-906f-697330638dc0,,2017-10-31T12:00:00.000Z,9987063,2017-10-31T12:00:00.060Z
ea9835aa-c1c6-88ef-4f0c-cb1e47a96258,7696,XBt,RealisedPNL,-115,0,Completed,XBTUSD,1f4f8e27-5a6e-a1a3-db2d-59c3bf54ce8b,,2017-10-30T12:00:00.000Z,9987176,2017-10-30T12:00:00.182Z
688f5097-9585-8d7d-f3a3-3024a0d2831e,7696,XBt,RealisedPNL,-120,0,Completed,XBTUSD,2f12194f-d6c9-2edc-de9b-7c5bcfa010c2,,2017-10-29T12:00:00.000Z,9987291,2017-10-29T12:00:00.196Z
928710a7-2d6c-2bec-4c41-e06b764d19c4,7696,XBt,RealisedPNL,-119,0,Completed,XBTUSD,19963c0f-b9df-d436-09a9-8cc5428659e5,,2017-10-28T12:00:00.000Z,9987411,2017-10-28T12:00:00.215Z
9ac42b09-c2d0-893f-9f7e-5d240645fc5d,7696,XBt,RealisedPNL,-117,0,Completed,XBTUSD,aa8d5736-ad02-2a78-f94a-e1078c84120f,,2017-10-27T12:00:00.000Z,9987530,2017-10-27T12:00:00.060Z
70fff389-1786-5c4b-5877-8df65480579a,7696,XBt,RealisedPNL,-122,0,Completed,XBTUSD,0ace5bd5-ea31-d4e4-b7cd-4e93e56013cc,,2017-10-26T12:00:00.000Z,9987647,2017-10-26T12:00:00.263Z
771da0b3-60c6-64f2-1746-5710ac676b2c,7696,XBt,RealisedPNL,-121,0,Completed,XBTUSD,674be4ac-aad6-989e-d5a5-dfed854bed59,,2017-10-25T12:00:00.000Z,9987769,2017-10-25T12:00:00.104Z
6141b757-7c2b-f02a-b590-ebcd81c29bbd,7696,XBt,RealisedPNL,-119,0,Completed,XBTUSD,37ff03f6-de08-8ba8-79bf-c9db3fee8494,,2017-10-24T12:00:00.000Z,9987890,2017-10-24T12:00:00.216Z
359900ef-c59c-217a-a405-5b2e4fc63878,7696,XBt,RealisedPNL,-117,0,Completed,XBTUSD,6f8124cb-7eee-1009-ec1e-282a417385cf,,2017-10-23T12:00:00.000Z,9988009,2017-10-23T12:00:00.006Z
ce090a3b-a690-4b2f-919a-11b70a1ba6c0,7696,XBt,RealisedPNL,-115,0,Completed,XBTUSD,5b7dd52b-2a4c-dad7-8e6b-23414b851ee1,,2017-10-22T12:00:00.000Z,9988126,2017-10-22T12:00:00.229Z
dd74a5e2-ba00-9b09-3936-6da003882022,7696,XBt,RealisedPNL,-117,0,Completed,XBTUSD,29b52391-7bea-9dbb-311a-4495b7d5b9e2,,2017-10-21T12:00:00.000Z,9988241,2017-10-21T12:00:00.267Z
10814a9b-4dbf-8db9-82f9-6ec22ab9c907,7696,XBt,RealisedPNL,-121,0,Completed,XBTUSD,f2777886-b5ad-3be6-81e7-0dea05ce34d1,,2017-10-20T12:00:00.000Z,9988358,2017-10-20T12:00:00.256Z
0fbcbd7c-e9e5-a58a-76c2-0af405484f06,7696,XBt,RealisedPNL,-127,0,Completed,XBTUSD,3c1fcafe-503c-998e-94c1-7b1cd006e42e,,2017-10-19T12:00:00.000Z,9988479,2017-10-19T12:00:00.075Z
c1a0b11d-ba0c-0ecf-4702-7dddaf23119d,7696,XBt,RealisedPNL,-124,0,Completed,XBTUSD,ce1d1f52-dfc5-a18e-dfd7-5c3e08a631a4,,2017-10-18T12:00:00.000Z,9988606,2017-10-18T12:00:00.045Z
e4e778b7-d8ed-66ef-30a3-54f853607fa1,7696,XBt,RealisedPNL,-121,0,Completed,XBTUSD,54546e8b-9c75-c64d-e97f-dd941dcf848a,,2017-10-17T12:00:00.000Z,9988730,2017-10-17T12:00:00.314Z
f682b596-b561-7505-882a-016256957dc5,7696,XBt,RealisedPNL,-125,0,Completed,XBTUSD,731707da-82e8-98c8-103b-5541dc14050d,,2017-10-16T12:00:00.000Z,9988851,2017-10-16T12:00:00.223Z
3a0496c5-024e-b1f9-c9ed-0e693c5a9883,7696,XBt,RealisedPNL,-121,0,Completed,XBTUSD,22ec1328-bf22-7c5c-8b56-77c5fb16fa21,,2017-10-15T12:00:00.000Z,9988976,2017-10-15T12:00:00.283Z
ec6557e5-1e99-668e-5e29-35496ecb1127,7696,XBt,RealisedPNL,-124,0,Completed,XBTUSD,38cd3d91-9e8a-0b2f-bdbd-71cd221fe2ed,,2017-10-14T12:00:00.000Z,9989097,2017-10-14T12:00:00.219Z
5065ecce-c5c3-5713-6327-6953b596fa50,7696,XBt,RealisedPNL,-128,0,Completed,XBTUSD,999eac0a-06ab-c3ae-6f41-0064a9fb9566,,2017-10-13T12:00:00.000Z,9989221,2017-10-13T12:00:00.222Z
f46cd9e3-87de-a401-1c92-cc6cde8d9960,7696,XBt,RealisedPNL,-143,0,Completed,XBTUSD,c9280eea-41eb-6e5c-8355-264d8dcbba38,,2017-10-12T12:00:00.000Z,9989349,2017-10-12T12:00:00.209Z
5ac7d81e-89fa-fc6a-90f7-c2b2cf01ebad,7696,XBt,RealisedPNL,-144,0,Completed,XBTUSD,8d85151e-8163-5b34-fe82-4bbab47e4bb6,,2017-10-11T12:00:00.000Z,9989492,2017-10-11T12:00:00.032Z
7fffb05a-1392-f834-1c1e-e06cdf38c1c5,7696,XBt,RealisedPNL,-146,0,Completed,XBTUSD,436a745f-ba8a-7ddd-4f53-1d5ecac8d666,,2017-10-10T12:00:00.000Z,9989636,2017-10-10T12:00:00.184Z
a5ee46bf-4bdb-c463-fb4a-4a97ab4ca1e5,7696,XBt,RealisedPNL,-151,0,Completed,XBTUSD,3c086e35-cb0d-9be3-b3d3-b6a8b91d0a13,,2017-10-09T12:00:00.000Z,9989782,2017-10-09T12:00:00.024Z
42fab8ff-db53-5ab9-2c5b-2a36c89cc93f,7696,XBt,RealisedPNL,-158,0,Completed,XBTUSD,39b1adb0-9225-1608-4dda-b0146150c080,,2017-10-08T12:00:00.000Z,9989933,2017-10-08T12:00:00.200Z
f85cff73-7eee-cd13-e814-84b0013a4fb1,7696,XBt,RealisedPNL,-158,0,Completed,XBTUSD,e22a6556-a26e-ac47-67ea-48569288f60b,,2017-10-07T12:00:00.000Z,9990091,2017-10-07T12:00:00.194Z
de5c8c09-0cfa-0e21-4185-2174fdae2e44,7696,XBt,RealisedPNL,-160,0,Completed,XBTUSD,dfa6e993-7358-7fe2-c543-86a9db23ba67,,2017-10-06T12:00:00.000Z,9990249,2017-10-06T12:00:00.316Z
c0e573d2-f153-1811-6a60-8ff92e344bd5,7696,XBt,RealisedPNL,-164,0,Completed,XBTUSD,a75c16b3-5ba1-d631-e267-cc35f16ec9ec,,2017-10-05T12:00:00.000Z,9990409,2017-10-05T12:00:00.187Z
801fb105-a409-f343-e7e3-e191d5649d8b,7696,XBt,RealisedPNL,-160,0,Completed,XBTUSD,bfd60ef2-e66d-719a-db76-e4709f24a3e4,,2017-10-04T12:00:00.000Z,9990573,2017-10-04T12:00:00.074Z
2dc47cf8-8d9d-6903-f1ff-3d02950cf23c,7696,XBt,RealisedPNL,-156,0,Completed,XBTUSD,bbc19ea7-a5ef-68a7-c536-3588623d2c0c,,2017-10-03T12:00:00.000Z,9990733,2017-10-03T12:00:00.254Z
b2473896-3f4d-0032-6171-bdd68709b97f,7696,XBt,RealisedPNL,-160,0,Completed,XBTUSD,e26efae2-d779-be18-a4fb-f885b69cad80,,2017-10-02T12:00:00.000Z,9990889,2017-10-02T12:00:00.233Z
f05cf283-afda-8670-364a-64d1f0307d61,7696,XBt,RealisedPNL,-161,0,Completed,XBTUSD,559b58fb-d90e-97ca-7a24-b79534c657ca,,2017-10-01T12:00:00.000Z,9991049,2017-10-01T12:00:00.387Z
69c67bde-f2c0-3099-1eae-30525ed21a0c,7696,XBt,RealisedPNL,-165,0,Completed,XBTUSD,851dd208-37c9-dd14-4bf3-9fe3b3c0fbd7,,2017-09-30T12:00:00.000Z,9991210,2017-09-30T12:00:00.279Z
de646ac0-b76a-06bf-e47e-00268f1cc201,7696,XBt,RealisedPNL,-8688,0,Completed,XBTUSD,e3322cec-5e1b-34f5-5a4f-8d57a46f27c3,,2017-09-29T12:00:00.000Z,9991375,2017-09-29T12:00:00.207Z
371ba9d5-b1ad-dd38-c9b4-2c1b84a42005,7696,XBt,RealisedPNL,58,0,Completed,XBTUSD,82e06d9a-d4e0-f0d3-e977-8c44906cfa54,,2017-09-28T12:00:00.000Z,10000063,2017-09-28T12:00:00.133Z
3af42a20-254c-903d-a42c-35522ae077aa,7696,XBt,RealisedPNL,60,0,Completed,XBTUSD,954da3d1-b13e-e5c2-9f12-2e36e85ccf86,,2017-09-27T12:00:00.000Z,10000005,2017-09-27T12:00:00.219Z
d03ce397-910a-8c6c-0404-1a9b275ce57a,7696,XBt,RealisedPNL,61,0,Completed,XBTUSD,7da34c4e-8f59-7bec-9743-9d5ac981cbff,,2017-09-26T12:00:00.000Z,9999945,2017-09-26T12:00:00.038Z
d6bc1110-7098-d3a3-dd76-9beaeebcfcc5,7696,XBt,RealisedPNL,65,0,Completed,XBTUSD,ba33cebc-6438-7083-7505-71530dc27e13,,2017-09-25T12:00:00.000Z,9999884,2017-09-25T12:00:00.301Z
ec097401-47be-a819-e9e2-ba0612d3c370,7696,XBt,RealisedPNL,63,0,Completed,XBTUSD,3bf0dd1c-8e5e-fb4e-5ba2-3ba568b8c021,,2017-09-24T12:00:00.000Z,9999819,2017-09-24T12:00:00.261Z
39d9cae4-43a6-69d9-9982-20bd7ad3c40c,7696,XBt,RealisedPNL,66,0,Completed,XBTUSD,93a49042-d4af-79bf-7317-2dbe3bf677bc,,2017-09-23T12:00:00.000Z,9999756,2017-09-23T12:00:00.275Z
63d85b71-77f6-0b0a-9eca-758e11c9a743,7696,XBt,RealisedPNL,65,0,Completed,XBTUSD,47537b90-cb89-428c-4fa8-92f888580063,,2017-09-22T12:00:00.000Z,9999690,2017-09-22T12:00:00.164Z
58e392ff-763a-3b41-51c7-5e815e7f5a14,7696,XBt,RealisedPNL,61,0,Completed,XBTUSD,0b591d39-8719-9fc5-a5fc-6e9e9218984a,,2017-09-21T12:00:00.000Z,9999625,2017-09-21T12:00:00.024Z
3204edfe-f4ff-d63d-66b5-944c2cda96cb,7696,XBt,RealisedPNL,62,0,Completed,XBTUSD,d7c58d46-67b6-0084-8660-cc4bf9ff2221,,2017-09-20T12:00:00.000Z,9999564,2017-09-20T12:00:00.044Z
8e98670c-2b8a-6f7b-5619-8617d394974b,7696,XBt,RealisedPNL,-502,0,Completed,XBTUSD,58415bec-5299-79a8-9267-f5aebc7386f1,,2017-09-19T12:00:00.000Z,9999502,2017-09-19T12:00:00.318Z
de104cf2-a32a-c524-92e9-7b6d55f5312c,7696,XBt,RealisedPNL,4,0,Completed,XBTUSD,08c53a14-79d9-3574-ed41-2685cba3233e,,2017-09-18T12:00:00.000Z,10000004,2017-09-18T12:00:00.016Z
340adfde-079b-33ef-fd5e-a349a407ca6a,7696,XBt,Transfer,10000000,,Completed,0,c43151d8-2646-c05e-8b5d-c656b450a92c,,2017-09-18T08:27:01.930Z,10000000,2017-09-18T08:27:01.930Z